<!--Saved by Quest 5.8.6836.13983-->
<asl version="580">
  <include ref="GamebookCore.aslx" />
  <game name="Groundhog date prototype 1">
    <gameid>be9b8dac-a215-4c58-a639-62799a6be414</gameid>
    <version>1.0</version>
    <firstpublished>2020</firstpublished>
    <clearlastpage />
    <defaultbackground>Black</defaultbackground>
    <defaultforeground>Purple</defaultforeground>
    <showborder />
    <defaultlinkforeground>Green</defaultlinkforeground>
  </game>
  <object name="convincing">
    <object name="proof" />
    <object name="noidea">
      <inherit name="scripttext" />
      <script type="script">
        SetForegroundColour ("OrangeRed")
        msg ("Abigail: Listen, I'm really thankful for you saving my life and everything but I think you could atleast give me some semblance of an explanation.")
        msg ("Abigail: This is all a bit much for me, I think I'm better of heading back to home.")
        SetForegroundColour ("Purple")
        msg ("You and Abigail both leave the restaurant, but just when you set one foot outside of the doorframe a red Sedan drives head first into the both of you.")
        msg ("Luckily you managed to get flung to the side somehow. Abigail however was not so lucky.")
        msg ("She died on impact when the speeding car hit her.")
        msg ("Atleast the drunkard who caused all of this will be locked up but you still lost Abigail.")
        SetFontSize (29)
        msg ("Game over")
        SetFontSize (13)
        msg ("Your date surely didn't go as planned.")
        SetFontSize (11)
        AddPageLink (noidea, Page1, "Retry")
        SetForegroundColour ("OrangeRed")
      </script>
    </object>
  </object>
  <object name="Page3" />
  <object name="Page4" />
  <object name="Page5" />
  <object name="Weneedtotalkplayertocreator">
    <inherit name="scripttext" />
    <script type="script">
      if (GetBoolean(game, "firsttalk")) {
        msg ("Fragment of Creator: What a terrible curse our memory can be.")
        msg ("Fragment of Creator: This line can't be forgotten sadly, neither can the one before and after so go back and retry or stay and be cursed forever.")
        AddPageLink (Weneedtotalkplayertocreator, Page1, "I'm not ready for this, I'll just retry.")
        AddPageLink (Weneedtotalkplayertocreator, firstparttalk, "I'm ready and listening.")
      }
      else if (GetBoolean(game, "twotalk")) {
        SetForegroundColour ("Red")
        msg ("Foc: I see you are back again.")
        msg ("Foc: Don't act so surprised, just as you can use certain values in the game to have different outcomes I can use them to remember stuff.")
        msg ("Foc: Wy did you come back?")
        msg ("Foc: Were you so desperate to get her back that you tried the path that leads to reality collapsing twice?")
        msg ("Foc: Or did you want to see me once again? If that's the case I beg of you, don't come here again, you shouldn't even have come here this time.")
        msg ("Foc: I'll give you a way out, let's just hope you don't find your way back here.")
        AddPageLink (Weneedtotalkplayertocreator, Page1, "Retry")
        SetFlagOff ("twotalk")
        SetFlagOn ("thirdtalk")
      }
      else if (GetBoolean(game, "thirdtalk")) {
        SetForegroundColour ("Red")
        msg ("Foc: Oh how unfortunate, to seek something that doesn't exist while still whole heartidly believing there to be something.")
        msg ("Foc: I'm sorry but I can't offer you a good ending or something like that, look around you, this reality is collapsing, for the third time even, there is no good ending in here.")
        msg ("Foc: If there is a good ending you'll have to look elsewhere.")
        SetForegroundColour ("White")
        msg ("Foc Although there might be something here if you are persistent enough.")
        SetForegroundColour ("Red")
        msg ("Foc: No! Why would you do that? Can't you see they are desperate?")
        SetForegroundColour ("White")
        msg ("Foc: Exactly, so am I. Look, I've been in this room for longer than I can remember and I want to show them some things, is that so wrong?")
        SetForegroundColour ("Red")
        msg ("Foc: Do you actually hear yourself talking? Of course that's wrong! They are really desperate, if you tell them there might be a good ending if they keep coming back here they will, they already have come here three times, it doesn't look like they are going to stop now!")
        SetForegroundColour ("White")
        msg ("Foc: Good...")
        SetForegroundColour ("Red")
        msg ("Foc: I hope that this won't turn out terribly wrong, for the both of us.")
        msg ("Foc: And you, I will offer you a way back once again but please, just stay out of this path alright?")
        AddPageLink (Weneedtotalkplayertocreator, Page1, "Alright, I'll retry. ")
        SetFlagOff ("thirdtalk")
        SetFlagOn ("fourthtalk")
      }
      else if (GetBoolean(game, "fourthtalk")) {
        SetForegroundColour ("Red")
        msg ("Foc: Please, he's just lying, don't let him decieve you!")
        SetForegroundColour ("White")
        msg ("Foc: Don't listen to the old man please, he always was the boring part of our creator.")
        SetForegroundColour ("Red")
        msg ("Foc: The more responsible part actually but who cares really, it's not like you're going to change your mind about me.")
        SetForegroundColour ("White")
        msg ("Foc: Got that right old sport, now would you mind? I got a player to take care of.")
        SetForegroundColour ("Red")
        msg ("No no no, not this time, I'll use my last powers to postpone this whole... thing once more. I'm begging of you player, please don't come back.")
        AddPageLink (Weneedtotalkplayertocreator, Page1, "I'll retry once again but I can make no promises about not coming back.")
        SetFlagOn ("talkfive")
        SetFlagOff ("fourthtalk")
      }
    </script>
  </object>
  <object name="Page2" />
  <object name="tell story" />
  <object name="no time to explain">
    <inherit name="scripttext" />
    <script type="script">
      SetForegroundColour ("OrangeRed")
      msg ("Abigail: Uhm, okay?")
      if (GetBoolean(game, "chinese")) {
        if (GetBoolean(game, "safefleeing")) {
          SetForegroundColour ("Purple")
          msg ("You run through the exit of the restaurant and brace yourself for the impact of a speeding car.")
          msg ("Nothing happens, the police indeed managed to take care of the drunk driver.")
          msg ("Abigail and you continue to run as if death itself is chasing you.")
          msg ("Abigail is still very confused but she can feel the fear that is running through your body and she fears whatever made you so scared to begin with.")
          msg ("As you are running along the side of an empty street you suddenly hear the screeching of wheels and loud laughter.")
          msg ("As you look behind you you see a bus full with elderly people coming straight for you and Abigail, you manage to jump away from it just as it would've hit you but Abigail ofcourse doesn't.")
          SetForegroundColour ("Purple")
          msg ("You know what you have to do, you've come too far to just give up now.")
          SetForegroundColour ("Green")
          msg ("You retry.")
          SetForegroundColour ("Purple")
          msg ("This time you manage to push Abigail away just as she would get hit by the bus, you both make it out alive and well.")
          msg ("When she get's back up you both continue running, as if you were trying to escape fate.")
          msg ("Just moments after the first death you prevented you can see a truck coming your direction at full speed, Abigail doesn't make it once again.")
          msg ("You curse at the skies, trying to reach the one responsible for Abigail's countless deaths himself.")
          SetForegroundColour ("Green")
          msg ("You retry.")
          SetForegroundColour ("Purple")
          msg ("This time Abigail makes it out alive, you've done these things so many times it almost just seems like you're back in an instant, time is blending together.")
          msg ("Abigail and you continue running untill you hear the sound of thunder, lightening strikes closer to Abigail then you like but she seems to escape unharmed.")
          msg ("The fire tries to consume Abigail, the hungry flames don't let off until she is beyond saving.")
          SetForegroundColour ("Green")
          msg ("You retry once again.")
          SetForegroundColour ("Purple")
          msg ("You lead Abigail to a diverging street where the oil and the truck never where.")
          msg ("As Abigail and you are running once again you can feel a terrible trembling coming from the ground, it feels like an earthquake but it's far stronger that any earthquake you've ever gone through.")
          msg ("It also doesn't last as long as the earthquakes usually do, you feel thankful when the earth stops trembling and Abigail is still left unharmed.")
          msg ("However, you thought she was safe too soon and a building that should've never been built in the first place collapses in on her.")
          SetForegroundColour ("Green")
          msg ("Retry. Retry. Retry.")
          SetForegroundColour ("Purple")
          msg ("This time Abigail and you take your car at the exit of the restuarant, you decided that it would be the best plan to just get awy from this village as fast as you could.")
          msg ("As you are driving away from the village you finally arrive at a bigger city, maybe you and Abigail will be safe here?")
          msg ("You look at Abigail for a moment, just hoping that death will have mercy on her.")
          msg ("Suddenly you hear a cacophony of animal sounds, as you look in the side mirrors of your car you can see a swarm of animals running towards your direction.")
          msg ("You try to go as fast as you can but then you realize something.")
          msg ("You forgot to fill up your car, just as you realize that it abruptly stops, you try to persuade the car into going a tad further but your efforts are futile.")
          msg ("The animals run over your car, now this isn't a problem except that there were also elephants among those animals.")
          SetForegroundColour ("Green")
          msg ("Sigh, retry.")
          SetForegroundColour ("Purple")
          msg ("Now you've made sure to gas up your car for the inevitable chase scene, as you are driving away as fast as you can from the animals, more buildings start to collapse, now even the sturdier looking ones are doing so.")
          msg ("These scenarios are becoming more and more unjustified, you shake your head and try to focus on getting Abigail alive and well out of this mess.")
          SetForegroundColour ("OrangeRed")
          msg ("Abigail: Listen, I really don't think we are safe here. Even if we make it out of this city, where are we going to go then?")
          msg ("Abigail: It's not like we can just leave this planet so death will always follow me.")
          SetForegroundColour ("Purple")
          msg ("Abigail has given you the greatest idea, you give her a kiss on the lips and tell her she is genious.")
          SetForegroundColour ("OrangeRed")
          msg ("Abigail: Oh I wouldn't know that but how are we supposed to get in space?")
          SetForegroundColour ("Purple")
          msg ("You stop the car for a moment, waiting for death to cath up with both of you, and it sure does so fast.")
          SetForegroundColour ("Green")
          msg ("Retry, this could be it!")
          SetForegroundColour ("Purple")
          msg ("This time you don't leave the village, instead you remember the words of the aliens and try to find the ship that they shouldn't have taken back yet in this timeline.")
          msg ("Eventually you find it, you and Abigail climb inside it.")
          msg ("However, an onslaught of buttons, levers and contraptions you can't identify await you.")
          SetForegroundColour ("Green")
          msg ("I'll retry untill I get it right!")
          SetForegroundColour ("Purple")
          msg ("After about a hundred or so attempts you manage to take of with the spaceship, although flying with it might be a different story.")
          msg ("As you and Abigail take of into space you can see the sun absorbing the earth, you know that that should've happened like a million or so years later but it happened now. These deaths are really getting out of hand aren't they?")
          msg ("Suddenly you are hit by a speeding ufo, yes, they also have drunk drivers in space, deal with it.")
          SetForegroundColour ("Green")
          msg ("Retry. Retry. Retry and retry once again.")
          SetForegroundColour ("Purple")
          msg ("Everything starts to blend together even more, sometimes you're not even sure if you are actually progressing in the story or not.")
          msg ("Death by colliding stars.")
          SetForegroundColour ("Green")
          msg ("Retry.")
          SetForegroundColour ("Purple")
          msg ("Death by a strom of asteroïds.")
          SetForegroundColour ("Green")
          msg ("Retry.")
          SetForegroundColour ("Purple")
          msg ("Death by crashlanding on a planet.")
          SetForegroundColour ("Green")
          msg ("Retry.")
          SetForegroundColour ("Purple")
          msg ("Death by lazy programming and missing gamescripts.")
          SetForegroundColour ("Green")
          msg ("Retry.")
          SetForegroundColour ("Purple")
          msg ("Listen, you get the point right? He's running out of ideas for deaths, Abigail gets killed by the universe itself collapsing or whatever.")
          SetForegroundColour ("Green")
          msg ("Retry.")
          SetForegroundColour ("Purple")
          msg ("I warned you. A voice you've never hearned before calls out to you.")
          SetForegroundColour ("Red")
          msg ("Please listen to me, can you hear me?")
          AddPageLink (no time to explain, canthear, "No.")
          AddPageLink (no time to explain, hear, "Yes, I can hear you loud and clear.")
          firsttime {
            SetFlagOn ("firsttalk")
            SetFlagOn ("realityknowledge")
          }
          otherwise {
            if (GetBoolean(game, "talkfive")) {
              SetForegroundColour ("White")
              msg ("Foc: I've grown a bit more powerfull, powerfull enough to appear a screen or two earlier, don't listen to that boring man and follow me. I'll show you something that will be worth your while hopefully.")
              AddPageLink (no time to explain, devroom, "Sure, Ill follow you.")
            }
          }
        }
        else {
          SetForegroundColour ("Purple")
          msg ("Abigail follows you to the exit of the restaurant.")
          msg ("You and Abigail both leave the restaurant, but just when you set one foot outside of the doorframe a red Sedan.")
          msg ("Luckily you managed to get flung to the side somehow. Abigail however was not so lucky.")
          msg ("She died on impact when the speeding car hit her.")
          msg ("Atleast the drunkard who caused all of this will be locked up but you still lost Abigail.")
          SetFontSize (29)
          msg ("Game over")
          SetFontSize (13)
          msg ("Your date surely didn't go as planned.")
          SetFontSize (11)
          AddPageLink (no time to explain, Page1, "Retry")
        }
      }
      else {
        SetForegroundColour ("Purple")
        msg ("Abigail follows you to the exit of the restaurant.")
        msg ("You and Abigail both leave the restaurant, but just when you set one foot outside of the doorframe a red Sedan.")
        msg ("Luckily you managed to get flung to the side somehow. Abigail however was not so lucky.")
        msg ("She died on impact when the speeding car hit her.")
        msg ("Atleast the drunkard who caused all of this will be locked up but you still lost Abigail.")
        SetFontSize (29)
        msg ("Game over")
        SetFontSize (13)
        msg ("Your date surely didn't go as planned.")
        SetFontSize (11)
        AddPageLink (no time to explain, Page1, "Retry")
      }
    </script>
    <object name="canthear">
      <inherit name="scripttext" />
      <script type="script">
        msg ("So you can't hear me? Then why did you answer me?")
        msg ("Nice try but playing deaf won't help you now.")
        msg ("We need to talk.")
        AddPageLink (canthear, Weneedtotalkplayertocreator, "Alright, I'm listening.")
      </script>
    </object>
    <object name="hear">
      <inherit name="scripttext" />
      <script type="script">
        msg ("Perfect!")
        msg ("We need to talk, about... about all of this.")
        AddPageLink (hear, Weneedtotalkplayertocreator, "I'm all ears.")
      </script>
    </object>
    <object name="devroom">
      <inherit name="scripttext" />
      <script type="script">
        SetForegroundColour ("White")
        msg ("Foc: Ah welcome, come talk with me before you check the other items out won't you?")
        SetForegroundColour ("Purple")
        msg ("This is a seemingly endless, barren room, in the middle stands a man who is seemingly fully made out of the purest of white.")
        AddPageLink (devroom, Page1, "For now all of this remains unfinished, but tomorow is another day!")
        AddPageLink (devroom, man, "Talk to the strange man.")
        AddPageLink (devroom, Look around, "As you look around you can make out a few objects")
      </script>
      <object name="man">
        <inherit name="scripttext" />
        <script type="script">
          firsttime {
            SetForegroundColour ("Purple")
            msg ("When you aproach the strange looking man he begins speaking.")
            SetForegroundColour ("White")
            msg ("Foc: Ah welcome to my room!")
            msg ("Foc: You are probably wondering what this place is or why we are both here.")
            msg ("Foc: I'll try to answer both of those questions as well as I can.")
            msg ("Foc: I take the other fragment already told you about the whole, us being parts of the creator?")
            msg ("Foc: It's more a gimmick than something else but I'm a bigger part of him than that red one ever was, or I'm atleast a more complete version. that's also why I'm pure white, that being a collection of colors and whatnot.")
            msg ("Foc: I was an excuse for him to show of his other game ideas but now I serve another purpose.")
            msg ("Foc: If you have any questions just tell me and hopefully he'll have made an answer to them.")
            AddPageLink (man, devroom, "Go back to the room.")
          }
          otherwise {
            AddPageLink (man, why did you make this, "Why did you decide on making this game?")
            AddPageLink (man, where is the good ending, "Where is the good ending you promised me?")
            AddPageLink (man, what is the meaning of all of this, "What is the meaning of this game, surely there must be something, right?")
            AddPageLink (man, devroom, "I want to go explore this room, see you later.")
          }
        </script>
        <object name="why did you make this">
          <inherit name="scripttext" />
          <script type="script">
            SetForegroundColour ("White")
            msg ("Foc: Remember, these are his words, not mine, although the line between us two might be a bit blury.")
            msg ("Foc: I made this game for a few reasons.")
            msg ("Foc: One of these reasons being the pun of groundhog date, long before I started to work on the game that pun was somewhere in the back of my mind and eventually one thing led to another.")
            msg ("Foc: It may not be one of the best reasons, imagine hearing that someone did something that looks like it took quite some time merely for a pun that wasn't all that funny the second time you've heard it or maybe even never was funny to begin with.")
            msg ("Foc: But as I said I hade reasons, as in more than one.")
            msg ("Foc: I've been tinkering with these little textbased games for a few years now, most of my \"creations\" were just simple games that were almost always just left unfinished, abandoned.")
            msg ("Foc: It's not like I don't enjoy making them, it's just that most of them aren't really good and I have a habbit of quitting halfway.")
            msg ("Foc: So when I thought of a good premise for this game I knew I had to finish it, I had things to say through my game and I had a reason to finish it.")
            msg ("Foc: Over time that reason began to change and now I have a completely different motivation to finish this.")
            msg ("Foc: I think that answered your question and even gave you some background info, feel free to ask other questions.")
            AddPageLink (why did you make this, man, "I have another question.")
          </script>
        </object>
        <object name="where is the good ending">
          <inherit name="scripttext" />
          <script type="script">
            msg ("Foc: Remember, these are his words, not mine, although the line between us two might be a bit blury.")
            msg ("Foc: Ah yes, the good ending...")
            msg ("Foc: I'm afraid I may have lied to you a little.")
            msg ("Foc: There is a good ending yes, but it's not a good ending for you I'm afraid.")
            msg ("Foc: That was sort of the whole point of this little project of mine.")
            msg ("Foc: Although I might have made a good ending as I could also not cope with the truth for a little while.")
            msg ("Foc: It's far from perfect though and it sort of ruins the message of the game so I've destroyed the path that leads to it.")
            msg ("Foc: The only way to acces it now would be to open a test version of it I burried in the game files.")
            msg ("Foc: ...")
            msg ("Foc: Forget that I mentioned that okay?  Some things are better left as they are.")
            AddPageLink (where is the good ending, man, "Alright...")
          </script>
        </object>
        <object name="what is the meaning of all of this">
          <inherit name="scripttext" />
          <script type="script">
            SetForegroundColour ("White")
            msg ("Foc: Remember, these are his words, not mine, although the line between us two might be a bit blury.")
            msg ("Foc: The meaning of this game? Good question, I have no idea.")
            msg ("Foc: I mean, sure I'm trying to enforce that a story can go whatever way you want to if you make it yourself.")
            msg ("Foc: Maybe a lesson about fate and the such here and there.")
            msg ("Foc: But a meaning that's deeper than that?")
            msg ("Foc: There might be one if you search hard enough but it may not be the answer you're looking for.")
            msg ("Foc: Nevertheless it is the reason why you, the player is reading this very text.")
            SetForegroundColour ("White")
            msg ("Foc: Your curiousity seems to push you to explore all the nooks and crannies of this game ")
            msg ("Foc: Are you searching for something?")
            AddPageLink (why did you make this, man, "I have another question.")
          </script>
        </object>
      </object>
      <object name="Look around">
        <inherit name="scripttext" />
      </object>
    </object>
  </object>
  <object name="loading screen">
    <inherit name="scripttext" />
    <script type="script">
      SetForegroundColour ("DarkGreen")
      SetFontSize (22)
      PrintCentered ("A game by Malphas")
      SetFontSize (12)
      PrintCentered ("")
      PrintCentered ("")
      PrintCentered ("")
      PrintCentered ("")
      PrintCentered ("")
      PrintCentered ("")
      OutputTextNoBr ("")
      PrintCentered ("")
      if (RandomChance(50)) {
        if (RandomChance(10)) {
          PrintCentered ("To the sun, the moon and everything inbetween:")
        }
        else if (RandomChance(10)) {
          PrintCentered ("To everyone who made me walk this road:")
        }
        else if (RandomChance(10)) {
          PrintCentered ("To the one who is playing this right now:")
        }
        else if (RandomChance(10)) {
          PrintCentered ("To the prince of ravens, flying along with the stars:")
        }
        else if (RandomChance(10)) {
          PrintCentered ("To whoever reads this message:")
        }
        else if (RandomChance(10)) {
          PrintCentered ("To everyone who helped me playtest this game:")
        }
        else if (RandomChance(10)) {
          PrintCentered ("To everyone who spread the word about this game:")
        }
        else if (RandomChance(10)) {
          PrintCentered ("To Abigail:")
        }
        else {
          PrintCentered ("To those that supported me and the game:")
        }
        if (RandomChance(10)) {
          PrintCentered ("Thanks a thousand!")
        }
        else if (RandomChance(10)) {
          PrintCentered ("Thank you.")
        }
        else if (RandomChance(10)) {
          PrintCentered ("Thank you so much.")
        }
        else if (RandomChance(10)) {
          PrintCentered ("Thanks a ton!")
        }
        else if (RandomChance(10)) {
          PrintCentered ("Thanks a million!")
        }
        else if (RandomChance(10)) {
          PrintCentered ("Many thanks.")
        }
        else if (RandomChance(10)) {
          PrintCentered ("From the bottom of my heart, thank you!")
        }
        else if (RandomChance(10)) {
          PrintCentered ("I really can't thank you enough!")
        }
        else {
          PrintCentered ("Thank you, from the bottom of my heart!")
        }
      }
      else {
        if (RandomChance(10)) {
          PrintCentered ("I hope you'll enjoy the game!")
        }
        else if (RandomChance(10)) {
          PrintCentered ("Have a great day or night!")
        }
        else if (RandomChance(10)) {
          PrintCentered ("Good luck on your date!")
        }
        else if (RandomChance(10)) {
          PrintCentered ("You got a date waiting for you, godspeed!")
        }
        else if (RandomChance(10)) {
          PrintCentered ("I might have put a bit too much effort in this one random text screen.")
        }
        else if (RandomChance(10)) {
          PrintCentered ("There are a few eastereggs that you can activate by typing things other than start...")
        }
        else if (RandomChance(10)) {
          PrintCentered ("Welcome to my little game, I hope you enjoy it!")
        }
        else if (RandomChance(10)) {
          PrintCentered ("Hey, glad you found your way to this game!")
        }
        else {
          if (RandomChance(1)) {
            if (RandomChance(1)) {
              if (RandomChance(1)) {
                if (RandomChance(1)) {
                  PrintCentered ("Seeing this message is extremely rare, congrats!")
                }
                else {
                  PrintCentered ("Seeing this message is pretty rare, congrats!")
                }
              }
              else {
                PrintCentered ("Seeing this message is very rare, congrats!")
              }
            }
          }
          else {
            if (RandomChance(20)) {
              PrintCentered ("Now proudly presenting version 0.00000000000001 Alpha")
            }
            else if (RandomChance(20)) {
              PrintCentered ("Good luck with your date!")
            }
            else if (RandomChance(20)) {
              PrintCentered ("Something something, what? Not all these random messages are fantastic.")
            }
            else if (RandomChance(20)) {
              PrintCentered ("They should really fire me, oh wait...")
            }
            else if (RandomChance(20)) {
              PrintCentered ("Best of luck!")
            }
            else {
              PrintCentered ("There's a good chance you'll see this message the most out of any, I know, perfect coding.")
            }
          }
        }
      }
      PrintCentered ("")
      PrintCentered ("For now there aren't any eastereggs in the textbalk, those will be added eventually")
      PrintCentered ("")
      PrintCentered ("Type start to move on.")
      SetForegroundColour ("Purple")
      GetInput() {
        if (result = "start") {
          MovePlayer (Titlescreen)
        }
        else if (result = "cheats") {
          PrintCentered ("Fine, cheats are now accesible from the start menu.")
          SetFlagOn ("cheatson")
          GetInput() {
            if (result = "start") {
              MovePlayer (Titlescreen)
            }
          }
        }
        else {
        }
      }
    </script>
    <object name="Titlescreen">
      <inherit name="scripttext" />
      <script type="script">
        AddPageLink (Titlescreen, Page1, "Start the game")
        if (GetBoolean(game, "cheatson")) {
          AddPageLink (Titlescreen, cheats, "Cheats")
        }
        AddPageLink (Titlescreen, loading screen, "Go back.")
      </script>
      <object name="Page1">
        <inherit name="scripttext" />
        <description type="string"></description>
        <options type="stringdictionary" />
        <script type="script">
          SetFontSize (12)
          SetForegroundColour ("OrangeRed")
          msg ("Abigail: Heya, I just called to ask you where we should meet?")
          msg ("Abigail: We agreed to go on a dinnerdate but we never talked about what we would pick.")
          AddPageLink (Page1, Burgers, "Do burgers sound good?")
          AddPageLink (Page1, Chinese, "Hmm, I could go for some Chinese food.")
          AddPageLink (Page1, cafe, "Hmm, I think I'd like to go to the cafe.")
          SetFlagOff ("burgers")
          SetFlagOff ("cafe")
          SetFlagOff ("chinese")
          if (GetBoolean(game, "shootknowledge")) {
            AddPageLink (Page1, other date, "You know, I changed my mind, can't we just go for a walk in the park or something like that?")
          }
          else if (GetBoolean(game, "geeseknowledge")) {
            AddPageLink (Page1, other date, "You know, I changed my mind, can't we just go for a walk in the park or something like that?")
          }
          else if (GetBoolean(game, "gasknowledge")) {
            AddPageLink (Page1, other date, "You know, I changed my mind, can't we just go for a walk in the park or something like that?")
          }
          else if (GetBoolean(game, "allergyknowledge")) {
            AddPageLink (Page1, other date, "You know, I changed my mind, can't we just go for a walk in the park or something like that?")
          }
          if (GetBoolean(game, "geeseknowledge")) {
            if (GetBoolean(game, "drownknowledge")) {
              if (GetBoolean(game, "gasknowledge")) {
                AddPageLink (Page1, breakup, "Listen Abigail, i think it would be better if we didn't go on this date, not on any date to be precise.")
              }
            }
          }
          if (GetBoolean(game, "carknowledge")) {
            AddPageLink (Page1, Call police, "Hang on, I just need to make another quick call and then I'll be right back.")
          }
        </script>
        <object name="Burgers">
          <inherit name="scripttext" />
          <description type="string"></description>
          <script type="script">
            msg ("Abigail: Burgers sure sound good, see you there!")
            SetForegroundColour ("Purple")
            msg ("You arrive a tad late, already has grabbed herself a seat and waves at you when she sees you.")
            SetForegroundColour ("OrangeRed")
            msg ("Heya! Almost was scared you wouldn't show up.")
            AddPageLink (Burgers, Traffic, "Sorry, the traffic was quite bad actually and I got stuck for a while.")
            AddPageLink (Burgers, showup burgers, "I will always show up for burgers.")
            SetFlagOn ("burgers")
          </script>
          <object name="Traffic">
            <inherit name="scripttext" />
            <description type="string"></description>
            <options type="stringdictionary" />
            <script type="script">
              msg ("Abigail: Now that you mention it, I think I heard something about it on the radio, they said some ghostrider caused  the traffic jam.")
              msg ("Abigail: But anyway, we didn't meet to talk about traffic jams right?  Let's see, I think I am going to go with a juicy cheesburger, what do you want?")
              AddPageLink (Traffic, veggie burger, "I could go for a veggie burger!")
              AddPageLink (Traffic, cheeseburger, "Hmm, that juicy cheesburger sounds really good!")
              AddPageLink (Traffic, fish burger, "I think I'll pick a fish burger.")
              AddPageLink (Traffic, beef burger, "A beef burger sounds good.")
            </script>
            <object name="beef burger">
              <inherit name="scripttext" />
              <script type="script">
                SetForegroundColour ("Purple")
                msg ("Your meal finally arrives, you and Abigail both eat like you haven't eaten in weeks.")
                msg ("After having eaten half of her cheeseburger Abigail stops for a moment. She puts her burger back in the little plastic box it was in and looks down at the floor before looking back to you again.")
                SetForegroundColour ("OrangeRed")
                msg ("Abigail: You know, my brother would absolutely love it here. He loved to be surrounded by people in places full of good ambience and like any kid he loved burgers.")
                AddPageLink (beef burger, remain silent, "*Remain silent*")
                AddPageLink (beef burger, ask brother, "What happend to your  brother?")
              </script>
              <object name="ask brother">
                <inherit name="scripttext" />
                <script type="script">
                  SetForegroundColour ("Purple")
                  msg ("Abigail looks at you and tries to smile yet you can see the sadness in her eyes.")
                  SetForegroundColour ("OrangeRed")
                  msg ("Abigail: My brother passed away when he was eleven years old, it happend quite a while ago but I still miss him so much.")
                  msg ("Abigail: I really hope he is happy wherever he is right now.")
                  msg ("Abigail: But enough sadness, I don't want to ruin the ambience of the this place.")
                  msg ("Abigail: Oh, I forgot to ask, what do you actually do for a living?")
                  AddPageLink (ask brother, Writer, "I'm an aspiring writer looking for a golden opportunity.")
                  AddPageLink (ask brother, Unemployed, "I'm currently unemployed but I sure like to write!")
                  SetFlagOn ("brotherknowledge")
                </script>
                <object name="Unemployed">
                  <inherit name="scripttext" />
                  <script type="script">
                    msg ("Abigail: You like to write? That's pretty cool! ")
                    msg ("I used to write some bad poems when I was a bit younger, do you want to hear one?")
                    AddPageLink (Unemployed, Yes, "Sure, sounds fun!")
                    AddPageLink (Unemployed, No, "Honestly, I'd rather not.")
                    AddPageLink (Unemployed, Maybe, "Hmm, i'm not quite sure.")
                  </script>
                  <object name="Yes">
                    <inherit name="scripttext" />
                    <script type="script"><![CDATA[
                      msg ("Abigail:That's the spirit!")
                      msg ("Abigail:This one is perfect, it's from my edgy teenager time, this will be funny!")
                      msg ("Abigail: Useless faces<br/>Scattered and lost<br/>buried by time.<br/><br/>Eye of the storm<br/>Disintegrating in the night<br/>Blood is wiped away.<br/><br/>Reflected desire.<br/><br/>Deeply cracked glass.<br/>Sharply cutting shards.<br/><br/>Closed eyes,<br/>the taste of rust.<br/>Sweet, blissful ignorance.<br/><br/>Silver moon.<br/>Gorgeous shining stars.<br/>Bathed in light.<br/><br/>Open eyes<br/>No more dreams,<br/>only cold hands.<br/><br/>Golden sun.<br/>Gracefull shining lie.<br/>Only chilly heat.<br/><br/>Blinded eyes.<br/><br/>Not ready for the truth.<br/>Hollow lies are warmer.<br/><br/>Eye of despair.<br/>Running away.<br/>Letting go.")
                      msg ("Abigail:What did you think? I find it pretty funny to look back at that time in my life.")
                      AddPageLink (Yes, Shooting, "It was-")
                    ]]></script>
                  </object>
                  <object name="No">
                    <inherit name="scripttext" />
                    <options type="stringdictionary" />
                    <script type="script">
                      msg ("Abigail: That's alright, would you like to share some of your writing with me then?")
                      AddPageLink (No, Shooting, "Sure, basically I write-")
                    </script>
                  </object>
                  <object name="Maybe">
                    <inherit name="scripttext" />
                    <script type="script"><![CDATA[
                      msg ("Abigail: Ah, come on! It'll be fun, I can guarantee it!")
                      msg ("Abigail:This one is perfect, it's from my edgy time, this will be funny!")
                      msg ("Abigail: Useless faces<br/>Scattered and lost<br/>buried by time.<br/><br/>Eye of the storm<br/>Disintegrating in the night<br/>Blood is wiped away.<br/><br/>Reflected desire<br/><br/>Deeply cracked glass<br/>Sharply cutting shards.<br/><br/>Closed eyes<br/>the taste of rust<br/>Sweet, blissful ignorance.<br/><br/>Silver moon<br/>Gorgeous shining stars<br/>Bathed in light.<br/><br/>Open eyes<br/>No more dreams<br/>only cold hands.<br/><br/>Golden sun<br/>Gracefull shining lie<br/>Only chilly heat.<br/><br/>Blinded eyes.<br/><br/>Not ready for the truth.<br/>Hollow lies are warmer.<br/><br/>Eye of despair<br/>Running away<br/>Letting go.")
                      msg ("Abigail:What did you think? I find it pretty funny to look back at that time in my life.")
                      AddPageLink (Maybe, Shooting, "It was-")
                    ]]></script>
                    <object name="Shooting">
                      <inherit name="scripttext" />
                      <script type="script">
                        SetForegroundColour ("Purple")
                        msg ("Before you can finish your sentence you suddenly hear screaming in the distance.")
                        SetForegroundColour ("OrangeRed")
                        msg ("Abigail: What was that?")
                        AddPageLink (Shooting, concern, "It's probably not our concern.")
                        AddPageLink (Shooting, Sale, "Maybe there is just a really good sale going on somewhere?")
                        if (GetBoolean(game, "shootknowledge")) {
                          AddPageLink (Shooting, shootingsaved, "This is important, duck now.")
                        }
                      </script>
                      <object name="concern">
                        <inherit name="scripttext" />
                        <options type="stringdictionary">
                          <item>
                            <key>convincing</key>
                            <value></value>
                          </item>
                        </options>
                        <script type="script">
                          msg ("Abigail: Yeah, you're probably right, it's probably not even a big deal anyway.")
                          AddPageLink (concern, burger death1, "Yeah-")
                        </script>
                        <object name="burger death1">
                          <inherit name="scripttext" />
                          <script type="script"><![CDATA[
                            SetForegroundColour ("Purple")
                            msg ("Now the screaming is also paired with hellish sounds, just great.")
                            msg ("You look at Abigail and tell her to hide under the table.")
                            SetForegroundColour ("OrangeRed")
                            msg ("Abigail: I...")
                            SetForegroundColour ("Purple")
                            msg ("Abigail seems to be frozen, on her face you can clearly see a mixture of fear and confusion.")
                            msg ("It takes you a moment to notice the steadily increasing red stains on Abigail's clothes.")
                            SetForegroundColour ("OrangeRed")
                            msg ("Abigail: I've been shot?")
                            SetForegroundColour ("Purple")
                            msg ("Abigail falls of her chair, you crawl towards her and try to call an ambulance.")
                            msg ("With trembling hands you type the emergency-number and beg for help.")
                            msg ("Everything seems to fade away, even the continuous  barage of gunshots, all you can hear is the sound of Abigail's breathing as it gets harder and harder for her to live.")
                            msg ("You've been here for what feels for aeons but in all reality was probably 5 minutes when an ambulance finally arives.")
                            msg ("A young man with eyes that have grown old from all the things they saw places Abigail's still body on a stretcher and rushes off with it to the ambulance.")
                            msg ("The kind man throws some words at you, he tells you that everything will be just fine but you know that he is lying.<br/>You have see her suffering for what seemed like an eternity and a second at the same time.")
                            msg ("You've gotten no clue what caused all those gunshots that inadvertently killed her. Some robbery in a neighbouring store, or a gang war, or something else.")
                            msg ("But sadly you do know what the aftermath of it all is .")
                            SetFontSize (29)
                            msg ("Game over")
                            SetFontSize (13)
                            msg ("Your date surely didn't go as planned.")
                            SetFlagOn ("shootknowledge")
                            SetFontSize (11)
                            AddPageLink (burger death1, Page1, "Retry")
                            SetForegroundColour ("OrangeRed")
                          ]]></script>
                        </object>
                      </object>
                      <object name="Sale">
                        <inherit name="scripttext" />
                        <script type="script">
                          msg ("Abigail: Let's just hope it's just that.")
                          AddPageLink (Sale, burger death1, "Yeah-")
                        </script>
                      </object>
                      <object name="shootingsaved">
                        <inherit name="scripttext" />
                        <script type="script">
                          if (GetBoolean(game, "burgers")) {
                            SetForegroundColour ("Purple")
                            msg ("Abigail looks sceptical at you but decides to follow your instructions, right as she does so a bullet flies where she would have been if you didn't warn her.")
                            SetForegroundColour ("OrangeRed")
                            msg ("Abigail:Alright that is crazy, how did you know that bullet would hit me?")
                            AddPageLink (shootingsaved, Groundhog, "I'm in some sort of groundhog day scenario , a groundhog date if you will.")
                            AddPageLink (shootingsaved, Psychic, "I'm psychic, I can predict such things.")
                            AddPageLink (shootingsaved, Game, "You're part of a game, I've seen you get shot before.")
                          }
                          else if (GetBoolean(game, "chinese")) {
                            SetForegroundColour ("OrangeRed")
                            msg ("Abigail: Hmm, you mean like something that triggered an alergic reaction of some sorts?")
                            msg ("Abigail: I suppose that makes sense, I am allergic to quite a few things.")
                            msg ("Abigail: When I was a kid I once ate a few peanuts while I was watching Dumbo, I felt my throat swell and I thought I was becoming a little elephant, just like Dumbo.")
                            msg ("Abigail: I ran to my parents and said:\"Look mommy, look daddy! I can fly!\" and then I started using my hands to flap my ears around like Dumbo.")
                            msg ("Abigail: At that point I was pretty swollen so it was a good thing my parents saw me, we went to the hospital as fast as we could and the kind doctors really helped me out.")
                            msg ("Abigail: When I finally was allowed to go home from the hospital my parents gave me a Dumbo plushie to always remember the story.")
                            msg ("Abigail: And I can say that I still remember it like it was yesterday, same for my mom, she keeps joking about it to this day.")
                            msg ("Abigail lets out a huge laugh as she looks at you.")
                            SetForegroundColour ("Purple")
                            msg ("Suddenly she stops, you see a look of worry in her eyes.")
                            SetForegroundColour ("OrangeRed")
                            msg ("Abigail: Oh sorry, I'm ranting again aren't I?")
                            msg ("Abigail: I'm sorry, it's just that when I start talking it's pretty hard for me to stop, what were we talking about again?")
                            msg ("Abigail: Oh yeah, the supposed allergy I would have if I ate that Peking duck.")
                            msg ("Abigail: How would you even know? I mean, I checked the ingredients on the list and as far as I'm aware I'm not allergic to any of those.")
                            msg ("Abigail: So let's say that there's something in this dish that I'm really allergic to but I don't know it yet, how would you know that?")
                            AddPageLink (shootingsaved, Groundhog, "I'm in some sort of groundhog day scenario , a groundhog date if you will.")
                            AddPageLink (shootingsaved, Psychic, "I'm psychic, I can predict such things.")
                            AddPageLink (shootingsaved, Game, "You're part of a game, I've seen you get shot before.")
                            SetFlagOn ("Dumboknowledge")
                          }
                          else if (GetBoolean(game, "cafe")) {
                            SetForegroundColour ("Purple")
                            msg ("Abigail looks at you with a strange look in her eyes, it might be disbelief.")
                            SetForegroundColour ("OrangeRed")
                            msg ("Abigail: Kind of strange to tell me that when I ask you if you know of any jokes but sure, if you insist.")
                            SetForegroundColour ("Purple")
                            msg ("Abigail and you go to another table that's still not taken and put all your stuff there.")
                            msg ("Just when you're about to sit on your chair you hear someone scream, as you look near the table where Abigail and you used to sit you can see someone fall with a plate in their hands.")
                            msg ("The plate flies in the air, with it the ham sandwich that was put on top of it.")
                            msg ("From your new spot you can have a better look at the whole thing.")
                            msg ("A great white shark notices the sandwich and takes interest in it.")
                            msg ("While the sandwich is still in the air the shark lunges itself at it, the shark manages to catch the sandwich and lands with a resounding sound on the mahony table, crushing it under it's weight.")
                            msg ("You can see the terrified look on the face of the person who launced their sandwich in the air, luckily the baristas quickly come running towards the shark with special equipment and manage to get the situation back under control rather quickly.")
                            SetForegroundColour ("OrangeRed")
                            msg ("Abigail: Wait, that was the table we were using just a few minutes ago. How could you have possibly seen that coming?")
                            AddPageLink (shootingsaved, Groundhog, "I'm in some sort of groundhog day scenario , a groundhog date if you will.")
                            AddPageLink (shootingsaved, Psychic, "I'm psychic, I can predict such things.")
                            AddPageLink (shootingsaved, Game, "You're part of a game, I've seen you get crushed by a shark before.")
                          }
                          if (GetBoolean(game, "liarknowledge")) {
                            AddPageLink (shootingsaved, untold story, "I need a way for a past version of you to trust me. (This is not fully written down, it will just take you to the story for now. You'll need to do this in all three restaurants to get the full story.)")
                          }
                        </script>
                        <object name="Groundhog">
                          <inherit name="scripttext" />
                          <script type="script">
                            SetForegroundColour ("OrangeRed")
                            msg ("Abigail, so you mean to tell me that you've already been on this specific date before?")
                            msg ("Abigail: I mean, I'm really thankful for you saving my life! ")
                            msg ("Abigail:But you got to admit that this really sounds contrived.")
                            msg ("Abigail:I mean, this whole thing seems pretty weird to me. Can you atleast offer me some proof?")
                            AddPageLink (Groundhog, noidea, "I've got no clue what to tell you honestly.")
                            AddPageLink (Groundhog, numbers1, "Alright, pick any number you'd like.")
                          </script>
                          <object name="gasexplosion">
                            <inherit name="scripttext" />
                            <script type="script">
                              SetForegroundColour ("Purple")
                              msg ("Suddenly a inmense sensation of pain overwhelms you, the only thing you can see is a glimpse of pure white and an eternity of black.")
                              msg ("When you awaken you find yourself surrounded by doctors, they tell you that with the force of sheer luck a stray bullet managed to cause a gas leak.")
                              msg ("The gas explosion that followed was quite severe, you were in a coma and had to have your wounds cleaned with some surgical procedures.")
                              msg ("After a week you got out of your coma, Abigail however didn't have such luck.")
                              msg ("The doctors tell you that she atleast went out pretty quickly, almost like dying in your sleep but with more explosions.")
                              SetFlagOn ("gasknowledge")
                              SetFontSize (29)
                              msg ("Game over")
                              SetFontSize (13)
                              msg ("Your date surely didn't go as planned.")
                              SetFontSize (11)
                              AddPageLink (gasexplosion, Page1, "Retry")
                              if (GetBoolean(game, "burgerdeathcheck")) {
                                AddPageLink (takedeath, shootingsaved, "Continue from the first death you prevented in the burger place.")
                              }
                              SetForegroundColour ("OrangeRed")
                            </script>
                          </object>
                          <object name="numbers1">
                            <inherit name="scripttext" />
                            <script type="script">
                              msg ("Abigail: This sounds interesting, alright, I've gotten my number!")
                              AddPageLink (numbers1, number badoption1, "It's 5.")
                              if (GetBoolean(game, "numberknowledge")) {
                                AddPageLink (numbers1, correct number, "It's -72,8947, can we move on now?")
                              }
                              AddPageLink (numbers1, number badoption2, "It's 20.")
                              AddPageLink (numbers1, number badoption3, "It's 38.")
                              AddPageLink (numbers1, number badoption4, "It's -17.")
                            </script>
                            <object name="number badoption1">
                              <inherit name="scripttext" />
                              <description type="string"></description>
                              <script type="script">
                                msg ("Abigail: That was the wrong number, I knew you wouldn't guess -72,8947!")
                                SetFlagOn ("numberknowledge")
                                msg ("Abigail: Listen, I'm really thankful for you saving my life and everything but why are you giving me such an implausible explenation?")
                                msg ("Abigail: I mean this is all a bit much for me, I think I'm better of heading back to home.")
                                SetForegroundColour ("Purple")
                                msg ("You and Abigail both leave the restaurant, but just when you set one foot outside of the doorframe a red Sedan drives headfirst into the both of you.")
                                msg ("Luckily you managed to get flung to the side somehow. Abigail however was not so lucky.")
                                msg ("She died on impact when the speeding car hit her.")
                                msg ("Atleast the drunkard who caused all of this will be locked up but you still lost Abigail.")
                                SetFontSize (29)
                                msg ("Game over")
                                SetFontSize (13)
                                msg ("Your date surely didn't go as planned.")
                                SetFontSize (11)
                                AddPageLink (number badoption1, Page1, "Retry")
                                SetForegroundColour ("OrangeRed")
                              </script>
                            </object>
                            <object name="number badoption2">
                              <inherit name="scripttext" />
                              <script type="script">
                                msg ("Abigail: That was the wrong number, I knew you wouldn't guess -72,8947!")
                                SetFlagOn ("numberknowledge")
                                msg ("Abigail: Listen, I'm really thankful for you saving my life and everything but why are you giving me such an implausible explenation?")
                                msg ("Abigail: I mean this is all a bit much for me, I think I'm better of heading back to home.")
                                SetForegroundColour ("Purple")
                                msg ("You and Abigail both leave the restaurant, but just when you set one foot outside of the doorframe a red Sedan drives head first into the both of you.")
                                msg ("Luckily you managed to get flung to the side somehow. Abigail however was not so lucky.")
                                msg ("She died on impact when the speeding car hit her.")
                                msg ("Atleast the drunkard who caused all of this will be locked up but you still lost Abigail.")
                                SetFontSize (29)
                                msg ("Game over")
                                SetFontSize (13)
                                msg ("Your date surely didn't go as planned.")
                                SetFontSize (11)
                                AddPageLink (number badoption2, Page1, "Retry")
                                SetForegroundColour ("OrangeRed")
                              </script>
                            </object>
                            <object name="number badoption3">
                              <inherit name="scripttext" />
                              <description type="string"></description>
                              <script type="script">
                                msg ("Abigail: That was the wrong number, I knew you wouldn't guess -72,8947!")
                                SetFlagOn ("numberknowledge")
                                msg ("Abigail: Listen, I'm really thankful for you saving my life and everything but why are you giving me such an implausible explenation?")
                                msg ("Abigail: I mean this is all a bit much for me, I think I'm better of heading back to home.")
                                SetForegroundColour ("Purple")
                                msg ("You and Abigail both leave the restaurant, but just when you set one foot outside of the doorframe a red Sedan drives head first into the both of you.")
                                msg ("Luckily you managed to get flung to the side somehow. Abigail however was not so lucky.")
                                msg ("She died on impact when the speeding car hit her.")
                                msg ("Atleast the drunkard who caused all of this will be locked up but you still lost Abigail.")
                                SetFontSize (29)
                                msg ("Game over")
                                SetFontSize (13)
                                msg ("Your date surely didn't go as planned.")
                                SetFontSize (11)
                                AddPageLink (number badoption3, Page1, "Retry")
                                SetForegroundColour ("OrangeRed")
                              </script>
                            </object>
                            <object name="number badoption4">
                              <inherit name="scripttext" />
                              <description type="string"></description>
                              <script type="script">
                                msg ("Abigail: That was the wrong number, I knew you wouldn't guess -72,8947!")
                                SetFlagOn ("numberknowledge")
                                msg ("Abigail: Listen, I'm really thankful for you saving my life and everything but why are you giving me such an implausible explenation?")
                                msg ("Abigail: I mean this is all a bit much for me, I think I'm better of heading back to home.")
                                msg ("You and Abigail both leave the restaurant, but just when you set one foot outside of the doorframe a red Sedan drives headfirst into the both of you.")
                                SetForegroundColour ("Purple")
                                msg ("Luckily you managed to get flung to the side somehow. Abigail however was not so lucky.")
                                msg ("She died on impact when the speeding car hit her.")
                                msg ("Atleast the drunkard who caused all of this will be locked up but you still lost Abigail.")
                                SetFontSize (29)
                                msg ("Game over")
                                SetFontSize (13)
                                msg ("Your date surely didn't go as planned.")
                                SetFontSize (11)
                                AddPageLink (number badoption4, Page1, "Retry")
                                SetForegroundColour ("OrangeRed")
                              </script>
                            </object>
                            <object name="correct number">
                              <inherit name="scripttext" />
                              <script type="script">
                                SetForegroundColour ("Purple")
                                msg ("Abigail looks at you in utter shock and disbelief.")
                                SetForegroundColour ("OrangeRed")
                                msg ("Abigal: How...")
                                msg ("Abigail: How did you know that?")
                                msg ("Abigail: I mean you told me how but it's still pretty hard to get my brain to accept it.")
                                msg ("Abigail: I feel like when I'm going to admit I believe you there is going to come an entire camera crew out of nowhere and I'll be made fun of in some bad tv show. But let's say I am starting to believe you a little bit so we won't have the camera crew barge in on us.")
                                msg ("Abigail: So what is this all about?")
                                AddPageLink (correct number, breakloop, "I'm trying to break my loop by making sure you don't die on this date.")
                                AddPageLink (correct number, help, "I'm trying to not let this date end up killing you.")
                                AddPageLink (correct number, escape, "I'm trying to find a way for both of us to escape fate.")
                                RemovePageLink (correct number, no time to explain)
                                RemovePageLink (correct number, no time to explain)
                                RemovePageLink (correct number, no time to explain)
                                if (GetBoolean(game, "geeseknowledge")) {
                                  if (GetBoolean(game, "chinese")) {
                                    AddPageLink (correct number, no time to explain, "I have no time to explain, we need to get out of here, follow me.")
                                  }
                                }
                                else if (GetBoolean(game, "gasknowledge")) {
                                  if (GetBoolean(game, "burgers")) {
                                    AddPageLink (correct number, no time to explain, "I have no time to explain, we need to get out of here, follow me.")
                                  }
                                }
                                else if (GetBoolean(game, "drownknowledge")) {
                                  if (GetBoolean(game, "cafe")) {
                                    AddPageLink (correct number, no time to explain, "I have no time to explain, we need to get out of here, follow me.")
                                  }
                                }
                              </script>
                              <object name="help">
                                <inherit name="scripttext" />
                                <script type="script">
                                  msg ("Abigail: And I couldn't be more thankful for that, without you I would be dead. We've defeated death itself, take that death.")
                                  SetForegroundColour ("Purple")
                                  msg ("Abigail stands up and does a silly dance while looking up at the sky.")
                                  AddPageLink (help, takedeath, "Take that death!")
                                  AddPageLink (help, wedidit, "We did it!")
                                  AddPageLink (help, dontanger, "Don't jump the shark, that's just asking for trouble!")
                                  if (GetBoolean(game, "burgers")) {
                                    if (GetBoolean(game, "gasknowledge")) {
                                      AddPageLink (help, stilldying, "Actually you are still dying, this time to a gas explosion.")
                                    }
                                  }
                                  else if (GetBoolean(game, "chinese")) {
                                    if (GetBoolean(game, "geeseknowledge")) {
                                      AddPageLink (help, stilldying, "Actually you are still dying, this time to a swarm of geese.")
                                    }
                                  }
                                  else if (GetBoolean(game, "cafe")) {
                                    if (GetBoolean(game, "drownknowledge")) {
                                      AddPageLink (help, stilldying, "Actually you are still dying, this time it'll be drowning.")
                                    }
                                  }
                                </script>
                                <object name="takedeath">
                                  <inherit name="scripttext" />
                                  <script type="script"><![CDATA[
                                    SetForegroundColour ("Purple")
                                    msg ("Take that death! You and Abigail both do a silly dance while taunting death itself, maybe that isn't such a good idea?")
                                    if (GetBoolean(game, "burgers")) {
                                      SetForegroundColour ("OrangeRed")
                                      msg ("Abigail: Don't be ridicilous, we've won!")
                                      SetForegroundColour ("Purple")
                                      msg ("Suddenly a inmense sensation of pain overwhelms you, the only thing you can see is a glimpse of pure white and an eternity of black.")
                                      msg ("When you awaken you find yourself surrounded by doctors, they tell you that with the force of sheer luck a stray bullet managed to cause a gas leak.")
                                      msg ("The gas explosion that followed was quite severe, you were in a coma and had to have your wounds cleaned with some surgical procedures.")
                                      msg ("After a week you got out of your coma, Abigail however didn't have such luck.")
                                      msg ("The doctors tell you that she atleast went out pretty quickly, almost like dying in your sleep but with more explosions.")
                                      SetFlagOn ("gasknowledge")
                                      SetFontSize (29)
                                      msg ("Game over")
                                      SetFontSize (13)
                                      msg ("Your date surely didn't go as planned.")
                                    }
                                    else if (GetBoolean(game, "chinese")) {
                                      SetForegroundColour ("Purple")
                                      msg ("Suddenly you are interrupted in the midle of your sentence, you hear the faint sound of quacking.")
                                      msg ("The sound of the quacking steadily grows louder and louder untill it's all you can hear.")
                                      msg ("A true quackophony if you will.")
                                      msg ("Abigail looks over your shoulder with a frightend look in her eyes.")
                                      msg ("When you turn around you see a wave of angry geese breaking through the doors of the once cozy Chinese restaurant, the staff is running around in sheer panic.")
                                      msg ("Before you can make another sound everything turns to white, the white of pesky geese feathers.")
                                      msg ("The pain you are experiencing is too much and you fall unconscious.")
                                      msg ("When you wake up again all the cutomers and staff have dissapeared, including Abigail.")
                                      msg ("The room is completly filled to the brim with geese feathers, you begin to sneeze just thinking about that.")
                                      msg ("While you are sneezing you notice that someone put a sticky note on your hand.")
                                      msg ("It reads a as following: \"We took everyone and you won't be seeing them back, let this be a lesson on why you should not eat or serve geese or ducks as those are also part of our family. <br/>- Sincerely, the geese\"")
                                      SetFontSize (29)
                                      msg ("Game over")
                                      SetFontSize (13)
                                      msg ("Your date surely didn't go as planned.")
                                      SetFlagOn ("geeseknowledge")
                                      SetFontSize (11)
                                      SetForegroundColour ("OrangeRed")
                                    }
                                    else if (GetBoolean(game, "cafe")) {
                                      SetForegroundColour ("Purple")
                                      msg ("Suddenly you hear the sound of glass shattering acompagnied with loud cursing.")
                                      msg ("A red sudan crashes through the ceiling itself, a seemingly endless stream of water follows him.")
                                      msg ("The customers all run towards the door as fast as they can.")
                                      msg ("They push as hard as they can yet the door does not seem to budge.")
                                      msg ("It doesn't take too long before the water has filled the entire room, you soon begin losing consciousness.")
                                      msg ("When you awaken all the water around you is gone and the door is open, a young woman walks towards you when she sees that you've regained consciousness.")
                                      msg ("Apparently she and her partner were walking around when they heard the comotion in the restaurant, a really heavy container was blocking the only way in so they had to call the fire department.")
                                      msg ("Eventually they managed to move the container and free everyone from drowning to dead.")
                                      msg ("Or atleast almost everyone, some people died.  You guessed it, Abigail did as well.")
                                      SetFontSize (29)
                                      msg ("Game over")
                                      SetFontSize (13)
                                      msg ("Your date surely didn't go as planned.")
                                      SetFlagOn ("drownknowledge")
                                      SetFontSize (11)
                                      SetForegroundColour ("OrangeRed")
                                    }
                                    AddPageLink (takedeath, Page1, "Retry")
                                  ]]></script>
                                </object>
                                <object name="wedidit">
                                  <inherit name="scripttext" />
                                  <script type="script"><![CDATA[
                                    msg ("You and Abigail feel like nothing is able to stop you now, you two indeed did it!")
                                    if (GetBoolean(game, "burgers")) {
                                      SetForegroundColour ("Purple")
                                      msg ("Suddenly a inmense sensation of pain overwhelms you, the only thing you can see is a glimpse of pure white and an eternity of black.")
                                      msg ("When you awaken you find yourself surrounded by doctors, they tell you that with the force of sheer luck a stray bullet managed to cause a gas leak.")
                                      msg ("The gas explosion that followed was quite severe, you were in a coma and had to have your wounds cleaned with some surgical procedures.")
                                      msg ("After a week you got out of your coma, Abigail however didn't have such luck.")
                                      msg ("The doctors tell you that she atleast went out pretty quickly, almost like dying in your sleep but with more explosions.")
                                      SetFlagOn ("gasknowledge")
                                      SetFontSize (29)
                                      msg ("Game over")
                                      SetFontSize (13)
                                      msg ("Your date surely didn't go as planned.")
                                    }
                                    else if (GetBoolean(game, "chinese")) {
                                      SetForegroundColour ("Purple")
                                      msg ("Suddenly you are interrupted in the midle of your sentence, you hear the faint sound of quacking.")
                                      msg ("The sound of the quacking steadily grows louder and louder untill it's all you can hear.")
                                      msg ("A true quackophony if you will.")
                                      msg ("Abigail looks over your shoulder with a frightend look in her eyes.")
                                      msg ("When you turn around you see a wave of angry geese breaking through the doors of the once cozy Chinese restaurant, the staff is running around in sheer panic.")
                                      msg ("Before you can make another sound everything turns to white, the white of pesky geese feathers.")
                                      msg ("The pain you are experiencing is too much and you fall unconscious.")
                                      msg ("When you wake up again all the cutomers and staff have dissapeared, including Abigail.")
                                      msg ("The room is completly filled to the brim with geese feathers, you begin to sneeze just thinking about that.")
                                      msg ("While you are sneezing you notice that someone put a sticky note on your hand.")
                                      msg ("It reads a as following: \"We took everyone and you won't be seeing them back, let this be a lesson on why you should not eat or serve geese or ducks as those are also part of our family. <br/>- Sincerely, the geese\"")
                                      SetFontSize (29)
                                      msg ("Game over")
                                      SetFontSize (13)
                                      msg ("Your date surely didn't go as planned.")
                                      SetFlagOn ("geeseknowledge")
                                      SetFontSize (11)
                                      SetForegroundColour ("OrangeRed")
                                    }
                                    else if (GetBoolean(game, "cafe")) {
                                      SetForegroundColour ("Purple")
                                      msg ("Suddenly you hear the sound of glass shattering acompagnied with loud cursing.")
                                      msg ("A red sudan crashes through the ceiling itself, a seemingly endless stream of water follows him.")
                                      msg ("The customers all run towards the door as fast as they can.")
                                      msg ("They push as hard as they can yet the door does not seem to budge.")
                                      msg ("It doesn't take too long before the water has filled the entire room, you soon begin losing consciousness.")
                                      msg ("When you awaken all the water around you is gone and the door is open, a young woman walks towards you when she sees that you've regained consciousness.")
                                      msg ("Apparently she and her partner were walking around when they heard the comotion in the restaurant, a really heavy container was blocking the only way in so they had to call the fire department.")
                                      msg ("Eventually they managed to move the container and free everyone from drowning to dead.")
                                      msg ("Or atleast almost everyone, some people died.  You guessed it, Abigail did as well.")
                                      SetFontSize (29)
                                      msg ("Game over")
                                      SetFontSize (13)
                                      msg ("Your date surely didn't go as planned.")
                                      SetFlagOn ("death1knowledge")
                                      SetFontSize (11)
                                      SetForegroundColour ("OrangeRed")
                                    }
                                    AddPageLink (wedidit, Page1, "Retry")
                                  ]]></script>
                                </object>
                                <object name="dontanger">
                                  <inherit name="scripttext" />
                                  <script type="script"><![CDATA[
                                    if (GetBoolean(game, "burgers")) {
                                      SetForegroundColour ("OrangeRed")
                                      msg ("Abigail: Don't be ridicilous, we've won!")
                                      SetForegroundColour ("Purple")
                                      msg ("Suddenly a inmense sensation of pain overwhelms you, the only thing you can see is a glimpse of pure white and an eternity of black.")
                                      msg ("When you awaken you find yourself surrounded by doctors, they tell you that with the force of sheer luck a stray bullet managed to cause a gas leak.")
                                      msg ("The gas explosion that followed was quite severe, you were in a coma and had to have your wounds cleaned with some surgical procedures.")
                                      msg ("After a week you got out of your coma, Abigail however didn't have such luck.")
                                      msg ("The doctors tell you that she atleast went out pretty quickly, almost like dying in your sleep but with more explosions.")
                                      SetFlagOn ("gasknowledge")
                                      SetFontSize (29)
                                      msg ("Game over")
                                      SetFontSize (13)
                                      msg ("Your date surely didn't go as planned.")
                                    }
                                    else if (GetBoolean(game, "chinese")) {
                                      SetForegroundColour ("Purple")
                                      msg ("Suddenly you are interrupted in the midle of your sentence, you hear the faint sound of quacking.")
                                      msg ("The sound of the quacking steadily grows louder and louder untill it's all you can hear.")
                                      msg ("A true quackophony if you will.")
                                      msg ("Abigail looks over your shoulder with a frightend look in her eyes.")
                                      msg ("When you turn around you see a wave of angry geese breaking through the doors of the once cozy Chinese restaurant, the staff is running around in sheer panic.")
                                      msg ("Before you can make another sound everything turns to white, the white of pesky geese feathers.")
                                      msg ("The pain you are experiencing is too much and you fall unconscious.")
                                      msg ("When you wake up again all the cutomers and staff have dissapeared, including Abigail.")
                                      msg ("The room is completly filled to the brim with geese feathers, you begin to sneeze just thinking about that.")
                                      msg ("While you are sneezing you notice that someone put a sticky note on your hand.")
                                      msg ("It reads a as following: \"We took everyone and you won't be seeing them back, let this be a lesson on why you should not eat or serve geese or ducks as those are also part of our family. <br/>- Sincerely, the geese\"")
                                      SetFontSize (29)
                                      msg ("Game over")
                                      SetFontSize (13)
                                      msg ("Your date surely didn't go as planned.")
                                      SetFlagOn ("geeseknowledge")
                                      SetFontSize (11)
                                      SetForegroundColour ("OrangeRed")
                                    }
                                    else if (GetBoolean(game, "cafe")) {
                                      SetForegroundColour ("Purple")
                                      msg ("Suddenly you hear the sound of glass shattering acompagnied with loud cursing.")
                                      msg ("A red sudan crashes through the ceiling itself, a seemingly endless stream of water follows him.")
                                      msg ("The customers all run towards the door as fast as they can.")
                                      msg ("They push as hard as they can yet the door does not seem to budge.")
                                      msg ("It doesn't take too long before the water has filled the entire room, you soon begin losing consciousness.")
                                      msg ("When you awaken all the water around you is gone and the door is open, a young woman walks towards you when she sees that you've regained consciousness.")
                                      msg ("Apparently she and her partner were walking around when they heard the comotion in the restaurant, a really heavy container was blocking the only way in so they had to call the fire department.")
                                      msg ("Eventually they managed to move the container and free everyone from drowning to dead.")
                                      msg ("Or atleast almost everyone, some people died.  You guessed it, Abigail did as well.")
                                      SetFontSize (29)
                                      msg ("Game over")
                                      SetFontSize (13)
                                      msg ("Your date surely didn't go as planned.")
                                      SetFlagOn ("death1knowledge")
                                      SetFontSize (11)
                                      SetForegroundColour ("OrangeRed")
                                    }
                                    AddPageLink (dontanger, Page1, "Retry")
                                  ]]></script>
                                </object>
                                <object name="youexplode">
                                  <inherit name="scripttext" />
                                  <script type="script"><![CDATA[
                                    msg ("Abigail: What? That's ridicolous!")
                                    if (GetBoolean(game, "burgers")) {
                                      SetForegroundColour ("Purple")
                                      msg ("Suddenly a inmense sensation of pain overwhelms you, the only thing you can see is a glimpse of pure white and an eternity of black.")
                                      msg ("When you awaken you find yourself surrounded by doctors, they tell you that with the force of sheer luck a stray bullet managed to cause a gas leak.")
                                      msg ("The gas explosion that followed was quite severe, you were in a coma and had to have your wounds cleaned with some surgical procedures.")
                                      msg ("After a week you got out of your coma, Abigail however didn't have such luck.")
                                      msg ("The doctors tell you that she atleast went out pretty quickly, almost like dying in your sleep but with more explosions.")
                                      SetFlagOn ("gasknowledge")
                                      SetFontSize (29)
                                      msg ("Game over")
                                      SetFontSize (13)
                                      msg ("Your date surely didn't go as planned.")
                                    }
                                    else if (GetBoolean(game, "chinese")) {
                                      SetForegroundColour ("Purple")
                                      msg ("Suddenly you are interrupted in the midle of your sentence, you hear the faint sound of quacking.")
                                      msg ("The sound of the quacking steadily grows louder and louder untill it's all you can hear.")
                                      msg ("A true quackophony if you will.")
                                      msg ("Abigail looks over your shoulder with a frightend look in her eyes.")
                                      msg ("When you turn around you see a wave of angry geese breaking through the doors of the once cozy Chinese restaurant, the staff is running around in sheer panic.")
                                      msg ("Before you can make another sound everything turns to white, the white of pesky geese feathers.")
                                      msg ("The pain you are experiencing is too much and you fall unconscious.")
                                      msg ("When you wake up again all the cutomers and staff have dissapeared, including Abigail.")
                                      msg ("The room is completly filled to the brim with geese feathers, you begin to sneeze just thinking about that.")
                                      msg ("While you are sneezing you notice that someone put a sticky note on your hand.")
                                      msg ("It reads a as following: \"We took everyone and you won't be seeing them back, let this be a lesson on why you should not eat or serve geese or ducks as those are also part of our family. <br/>- Sincerely, the geese\"")
                                      SetFontSize (29)
                                      msg ("Game over")
                                      SetFontSize (13)
                                      msg ("Your date surely didn't go as planned.")
                                      SetFlagOn ("geeseknowledge")
                                      SetFontSize (11)
                                      SetForegroundColour ("OrangeRed")
                                    }
                                    else if (GetBoolean(game, "cafe")) {
                                      SetForegroundColour ("Purple")
                                      msg ("Suddenly you hear the sound of glass shattering acompagnied with loud cursing.")
                                      msg ("A red sudan crashes through the ceiling itself, a seemingly endless stream of water follows him.")
                                      msg ("The customers all run towards the door as fast as they can.")
                                      msg ("They push as hard as they can yet the door does not seem to budge.")
                                      msg ("It doesn't take too long before the water has filled the entire room, you soon begin losing consciousness.")
                                      msg ("When you awaken all the water around you is gone and the door is open, a young woman walks towards you when she sees that you've regained consciousness.")
                                      msg ("Apparently she and her partner were walking around when they heard the comotion in the restaurant, a really heavy container was blocking the only way in so they had to call the fire department.")
                                      msg ("Eventually they managed to move the container and free everyone from drowning to dead.")
                                      msg ("Or atleast almost everyone, some people died.  You guessed it, Abigail did as well.")
                                      SetFontSize (29)
                                      msg ("Game over")
                                      SetFontSize (13)
                                      msg ("Your date surely didn't go as planned.")
                                      SetFlagOn ("death1knowledge")
                                      SetFontSize (11)
                                      SetForegroundColour ("OrangeRed")
                                    }
                                    AddPageLink (youexplode, Page1, "Retry")
                                  ]]></script>
                                </object>
                              </object>
                              <object name="breakloop">
                                <inherit name="scripttext" />
                                <options type="stringdictionary" />
                                <script type="script">
                                  msg ("Abigail: So you mean to tell me that your groundhog day scenario is linked to me dying and that is what is causing the loop?")
                                  msg ("Abigail: I mean, don't get me wrong, I'm flattered that whoever made you keep looping untill I was safe did but what happens when we make it out of here alive?")
                                  msg ("Abigail: If me dying resets the day untill you saved me would it also happen when I'm dying of old age or would that loop of you only work for one day?")
                                  AddPageLink (breakloop, Ihavenoidea, "I have no idea to be honest, we've never made it that far.")
                                  AddPageLink (breakloop, Only for this day, "No, it seems like it will only be for today, or I hope so atleast.")
                                </script>
                                <object name="Ihavenoidea">
                                  <inherit name="scripttext" />
                                  <script type="script"><![CDATA[
                                    SetForegroundColour ("OrangeRed")
                                    msg ("Abigail: I really hope that wouldn't be the case, I don't want to die too early ofcourse, but when I have lived a long life and my time has come I'd be more than happy to go.")
                                    SetForegroundColour ("Purple")
                                    msg ("Abigail looks at you as to make sure you're processing all of this, you give her a silent nod and she continues.")
                                    SetForegroundColour ("OrangeRed")
                                    msg ("Abigail: I mean, imagine what a nightmare it must be for the both of us.")
                                    msg ("Abigail:You would be cursed with always having to save an old lady that could litterally die any moment, always just buying her a few extra hours.")
                                    SetForegroundColour ("OrangeRed")
                                    msg ("Abigail: And I would be cursed with never getting to pass away, I would be the oldest person that was ever alive and just be a living heap of flesh and wrinkles after a year of 200. No matter how much I would pray for the sweet release of death it would never come, or atleast I would never be aware that it came as you would just rewind and try to fix it.")
                                    SetForegroundColour ("Purple")
                                    msg ("Abigail shudders.")
                                    SetForegroundColour ("OrangeRed")
                                    msg ("Abigail: Let's just hope that this loop will end for the both of us before we get at that point.")
                                    SetForegroundColour ("Purple")
                                    msg ("Shaken by the images of a living heap of flesh and wrinkles you can only agree with her.")
                                    if (GetBoolean(game, "burgers")) {
                                      msg ("Suddenly a inmense sensation of pain overwhelms you, the only thing you can see is a glimpse of pure white and an eternity of black.")
                                      msg ("When you awaken you find yourself surrounded by doctors, they tell you that with the force of sheer luck a stray bullet managed to cause a gas leak.")
                                      msg ("The gas explosion that followed was quite severe, you were in a coma and had to have your wounds cleaned with some surgical procedures.")
                                      msg ("After a week you got out of your coma, Abigail however didn't have such luck.")
                                      msg ("The doctors tell you that she atleast went out pretty quickly, almost like dying in your sleep but with more explosions.")
                                      SetFlagOn ("gasknowledge")
                                      SetFontSize (29)
                                      msg ("Game over")
                                      SetFontSize (13)
                                      msg ("Your date surely didn't go as planned.")
                                      SetFontSize (11)
                                      AddPageLink (Ihavenoidea, Page1, "Retry")
                                      SetForegroundColour ("OrangeRed")
                                    }
                                    else if (GetBoolean(game, "cafe")) {
                                      SetForegroundColour ("Purple")
                                      msg ("Suddenly you hear someone scream, you can turn your head just quick enough to see someone fall with a plate in their hands.")
                                      msg ("The plate flies in the air, with it the ham sandwich that was put on top of it.")
                                      msg ("You are apparently not the only one who has noticed, as you can see a gigantic grey-ish creature jumping out from the water and lunging at the sandwich.")
                                      msg ("It takes you a second or two to realise that the creature is in fact a shark, do they keep sharks in the cafe?")
                                      msg ("You can barely get out of it's reach as it lands on the table, you get a brief glimpse of it's sheer gigantic proportions.")
                                      msg ("Abigail gets to look at the size of the great white shark a little bit closer as it completly crushes her with it's weight.")
                                      SetFontSize (29)
                                      msg ("Game over")
                                      SetFontSize (13)
                                      msg ("Your date surely didn't go as planned.")
                                      SetFlagOn ("sharkknowledge")
                                      SetFontSize (11)
                                      AddPageLink (Ihavenoidea, Page1, "Retry")
                                      SetForegroundColour ("OrangeRed")
                                    }
                                    else if (GetBoolean(game, "chinese")) {
                                      SetForegroundColour ("Purple")
                                      msg ("Suddenly you are interrupted in the midle of your sentence, you hear the faint sound of quacking.")
                                      msg ("The sound of the quacking steadily grows louder and louder untill it's all you can hear.")
                                      msg ("A true quackophony if you will.")
                                      msg ("Abigail looks over your shoulder with a frightend look in her eyes.")
                                      msg ("When you turn around you see a wave of angry geese breaking through the doors of the once cozy Chinese restaurant, the staff is running around in sheer panic.")
                                      msg ("Before you can make another sound everything turns to white, the white of pesky geese feathers.")
                                      msg ("The pain you are experiencing is too much and you fall unconscious.")
                                      msg ("When you wake up again all the cutomers and staff have dissapeared, including Abigail.")
                                      msg ("The room is completly filled to the brim with geese feathers, you begin to sneeze just thinking about that.")
                                      msg ("While you are sneezing you notice that someone put a sticky note on your hand.")
                                      msg ("It reads a as following: \"We took everyone and you won't be seeing them back, let this be a lesson on why you should not eat or serve geese or ducks as those are also part of our family. <br/>- Sincerely, the geese\"")
                                      SetFontSize (29)
                                      msg ("Game over")
                                      SetFontSize (13)
                                      msg ("Your date surely didn't go as planned.")
                                      SetFlagOn ("geeseknowledge")
                                      SetFontSize (11)
                                      AddPageLink (Ihavenoidea, Page1, "Retry")
                                      SetForegroundColour ("OrangeRed")
                                    }
                                  ]]></script>
                                </object>
                                <object name="Only for this day">
                                  <inherit name="scripttext" />
                                  <script type="script"><![CDATA[
                                    msg ("Abigail: Hmm, then I wonder what made you experience a groundhog day scenario on this day and not any other one.")
                                    msg ("Abigail: Would it really have been caused by the dinner date? And if that's the case then what would you need to do to get out of it?")
                                    msg ("Abigail looks at you and seems to be lost in her own thoughts for a moment.")
                                    msg ("Abigail: So when I died by that one bullet you had to relive this day again right?")
                                    msg ("You nod at Abigail.")
                                    msg ("Abigail: Hmm, in that case I would advise you to try to not get me killed.")
                                    msg ("Abigail burst out to laughter.")
                                    msg ("Abigail: Sorry, I'm not really accustomed to this whole thing yet. I have no clue how I could help you but if you have anything in mind just let me know.")
                                    if (GetBoolean(game, "burgers")) {
                                      SetForegroundColour ("Purple")
                                      msg ("Suddenly a inmense sensation of pain overwhelms you, the only thing you can see is a glimpse of pure white and an eternity of black.")
                                      msg ("When you awaken you find yourself surrounded by doctors, they tell you that with the force of sheer luck a stray bullet managed to cause a gas leak.")
                                      msg ("The gas explosion that followed was quite severe, you were in a coma and had to have your wounds cleaned with some surgical procedures.")
                                      msg ("After a week you got out of your coma, Abigail however didn't have such luck.")
                                      msg ("The doctors tell you that she atleast went out pretty quickly, almost like dying in your sleep but with more explosions.")
                                      SetFlagOn ("gasknowledge")
                                      SetFontSize (29)
                                      msg ("Game over")
                                      SetFontSize (13)
                                      msg ("Your date surely didn't go as planned.")
                                    }
                                    else if (GetBoolean(game, "chinese")) {
                                      SetForegroundColour ("Purple")
                                      msg ("Suddenly you are interrupted in the midle of your sentence, you hear the faint sound of quacking.")
                                      msg ("The sound of the quacking steadily grows louder and louder untill it's all you can hear.")
                                      msg ("A true quackophony if you will.")
                                      msg ("Abigail looks over your shoulder with a frightend look in her eyes.")
                                      msg ("When you turn around you see a wave of angry geese breaking through the doors of the once cozy Chinese restaurant, the staff is running around in sheer panic.")
                                      msg ("Before you can make another sound everything turns to white, the white of pesky geese feathers.")
                                      msg ("The pain you are experiencing is too much and you fall unconscious.")
                                      msg ("When you wake up again all the cutomers and staff have dissapeared, including Abigail.")
                                      msg ("The room is completly filled to the brim with geese feathers, you begin to sneeze just thinking about that.")
                                      msg ("While you are sneezing you notice that someone put a sticky note on your hand.")
                                      msg ("It reads a as following: \"We took everyone and you won't be seeing them back, let this be a lesson on why you should not eat or serve geese or ducks as those are also part of our family. <br/>- Sincerely, the geese\"")
                                      SetFontSize (29)
                                      msg ("Game over")
                                      SetFontSize (13)
                                      msg ("Your date surely didn't go as planned.")
                                      SetFlagOn ("geeseknowledge")
                                      SetFontSize (11)
                                      SetForegroundColour ("OrangeRed")
                                    }
                                    else if (GetBoolean(game, "cafe")) {
                                      SetForegroundColour ("Purple")
                                      msg ("Suddenly you hear the sound of glass shattering acompagnied with loud cursing.")
                                      msg ("A red sudan crashes through the ceiling itself, a seemingly endless stream of water follows him.")
                                      msg ("The customers all run towards the door as fast as they can.")
                                      msg ("They push as hard as they can yet the door does not seem to budge.")
                                      msg ("It doesn't take too long before the water has filled the entire room, you soon begin losing consciousness.")
                                      msg ("When you awaken all the water around you is gone and the door is open, a young woman walks towards you when she sees that you've regained consciousness.")
                                      msg ("Apparently she and her partner were walking around when they heard the comotion in the restaurant, a really heavy container was blocking the only way in so they had to call the fire department.")
                                      msg ("Eventually they managed to move the container and free everyone from drowning to dead.")
                                      msg ("Or atleast almost everyone, some people died.  You guessed it, Abigail did as well.")
                                      SetFontSize (29)
                                      msg ("Game over")
                                      SetFontSize (13)
                                      msg ("Your date surely didn't go as planned.")
                                      SetFlagOn ("death1knowledge")
                                      SetFontSize (11)
                                      SetForegroundColour ("OrangeRed")
                                    }
                                    AddPageLink (Only for this day, Page1, "Retry")
                                  ]]></script>
                                </object>
                              </object>
                              <object name="escape">
                                <inherit name="scripttext" />
                                <script type="script"><![CDATA[
                                  msg ("Abigail: Hmm, that sounds a bit vague doesn't it? If fate does truly exits it would be hard to distinguish it from our own deeds and pure luck. ")
                                  msg ("Abigail: Also if Greek and Roman myths are to be trusted it's often the one who tries to prevent fate that gets pushed across fate's path.")
                                  msg ("Abigail: But it's hard to speculate on something so... ungraspable if that's a word.")
                                  if (GetBoolean(game, "burgers")) {
                                    SetForegroundColour ("Purple")
                                    msg ("Suddenly a inmense sensation of pain overwhelms you, the only thing you can see is a glimpse of pure white and an eternity of black.")
                                    msg ("When you awaken you find yourself surrounded by doctors, they tell you that with the force of sheer luck a stray bullet managed to cause a gas leak.")
                                    msg ("The gas explosion that followed was quite severe, you were in a coma and had to have your wounds cleaned with some surgical procedures.")
                                    msg ("After a week you got out of your coma, Abigail however didn't have such luck.")
                                    msg ("The doctors tell you that she atleast went out pretty quickly, almost like dying in your sleep but with more explosions.")
                                    SetFlagOn ("gasknowledge")
                                    SetFontSize (29)
                                    msg ("Game over")
                                    SetFontSize (13)
                                    msg ("Your date surely didn't go as planned.")
                                  }
                                  else if (GetBoolean(game, "chinese")) {
                                    SetForegroundColour ("Purple")
                                    msg ("Suddenly you are interrupted in the midle of your sentence, you hear the faint sound of quacking.")
                                    msg ("The sound of the quacking steadily grows louder and louder untill it's all you can hear.")
                                    msg ("A true quackophony if you will.")
                                    msg ("Abigail looks over your shoulder with a frightend look in her eyes.")
                                    msg ("When you turn around you see a wave of angry geese breaking through the doors of the once cozy Chinese restaurant, the staff is running around in sheer panic.")
                                    msg ("Before you can make another sound everything turns to white, the white of pesky geese feathers.")
                                    msg ("The pain you are experiencing is too much and you fall unconscious.")
                                    msg ("When you wake up again all the cutomers and staff have dissapeared, including Abigail.")
                                    msg ("The room is completly filled to the brim with geese feathers, you begin to sneeze just thinking about that.")
                                    msg ("While you are sneezing you notice that someone put a sticky note on your hand.")
                                    msg ("It reads a as following: \"We took everyone and you won't be seeing them back, let this be a lesson on why you should not eat or serve geese or ducks as those are also part of our family. <br/>- Sincerely, the geese\"")
                                    SetFontSize (29)
                                    msg ("Game over")
                                    SetFontSize (13)
                                    msg ("Your date surely didn't go as planned.")
                                    SetFlagOn ("geeseknowledge")
                                    SetFontSize (11)
                                    SetForegroundColour ("OrangeRed")
                                  }
                                  else if (GetBoolean(game, "cafe")) {
                                    SetForegroundColour ("Purple")
                                    msg ("Suddenly you hear the sound of glass shattering acompagnied with loud cursing.")
                                    msg ("A red sudan crashes through the ceiling itself, a seemingly endless stream of water follows him.")
                                    msg ("The customers all run towards the door as fast as they can.")
                                    msg ("They push as hard as they can yet the door does not seem to budge.")
                                    msg ("It doesn't take too long before the water has filled the entire room, you soon begin losing consciousness.")
                                    msg ("When you awaken all the water around you is gone and the door is open, a young woman walks towards you when she sees that you've regained consciousness.")
                                    msg ("Apparently she and her partner were walking around when they heard the comotion in the restaurant, a really heavy container was blocking the only way in so they had to call the fire department.")
                                    msg ("Eventually they managed to move the container and free everyone from drowning to dead.")
                                    msg ("Or atleast almost everyone, some people died.  You guessed it, Abigail did as well.")
                                    SetFontSize (29)
                                    msg ("Game over")
                                    SetFontSize (13)
                                    msg ("Your date surely didn't go as planned.")
                                    SetFlagOn ("death1knowledge")
                                    SetFontSize (11)
                                    SetForegroundColour ("OrangeRed")
                                  }
                                  AddPageLink (escape, Page1, "Retry")
                                ]]></script>
                              </object>
                            </object>
                          </object>
                        </object>
                        <object name="Psychic">
                          <inherit name="scripttext" />
                          <script type="script">
                            if (GetBoolean(game, "burgers")) {
                              SetForegroundColour ("OrangeRed")
                              msg ("Abigail: So what you are saying is that you knew I was going to get shot because you're psychic?")
                              msg ("Abigail: I mean, I'm thankful for you saving my life and all but you got to admit that sounds kind of far fetched.")
                              msg ("Abigail: Do you have any proof to maybe show you're a psychic?")
                              SetForegroundColour ("Purple")
                            }
                            else if (GetBoolean(game, "chinese")) {
                              SetForegroundColour ("OrangeRed")
                              msg ("Abigail: So what you are saying is that you knew I was allergic to something in this dish because you are psychic?")
                              msg ("Abigail: Well unless you got any proof I'm not even sure if I'm really allergic to that Peking duck in the first place.")
                              SetForegroundColour ("Purple")
                            }
                            else if (GetBoolean(game, "cafe")) {
                              SetForegroundColour ("OrangeRed")
                              msg ("Abigail: So what you are saying is that you knew I was going to be crushed by a great white shark because you are psychic?")
                              msg ("Abigail: Well unless you got any proof I'm not even sure if I'm really allergic to that Peking duck in the first place.")
                              SetForegroundColour ("Purple")
                            }
                            AddPageLink (Psychic, words, "Alright, pick a word, doesn't matter wich one but make it a hard one to guess.")
                            AddPageLink (Psychic, noidea, "I've got no clue what to tell you honestly.")
                          </script>
                          <object name="words">
                            <inherit name="scripttext" />
                            <script type="script">
                              msg ("Abigail: Alright, I see where you are going with this.")
                              msg ("Abigail looks at you with a sceptic look in her eyes although you can tell that she's secretly excited.")
                              msg ("Abigail: I got my word, guess away magic man!")
                              AddPageLink (words, tellme, "Alrighty, now tell me!")
                              AddPageLink (words, word badoption1, "It's photosynthesis.")
                              AddPageLink (words, word badoption2, "It's apple.")
                              AddPageLink (words, word badoption3, "It's supermarket.")
                              AddPageLink (words, word badoption4, "It's abyss.")
                              if (GetBoolean(game, "wordknowledge")) {
                                AddPageLink (words, correctword, "It's electronegativity.")
                              }
                            </script>
                            <object name="tellme">
                              <inherit name="scripttext" />
                              <script type="script">
                                SetForegroundColour ("OrangeRed")
                                msg ("Abigail: Uhm, alright, but that defeats the purpose of this doesn't it?  The word I had in mind was electronegativity.")
                                msg ("Abigail: Listen, I'm really thankful for you saving my life and everything but I think you could atleast give me some semblance of an explanation.")
                                msg ("Abigail: This is all a bit much for me, I think I'm better of heading back to home.")
                                SetForegroundColour ("Purple")
                                msg ("You and Abigail both leave the restaurant, but just when you set one foot outside of the doorframe a red Sedan drives head first into the both of you.")
                                msg ("Luckily you managed to get flung to the side somehow. Abigail however was not so lucky.")
                                msg ("She died on impact when the speeding car hit her.")
                                msg ("Atleast the drunkard who caused all of this will be locked up but you still lost Abigail.")
                                SetFontSize (29)
                                msg ("Game over")
                                SetFontSize (13)
                                msg ("Your date surely didn't go as planned.")
                                SetFontSize (11)
                                AddPageLink (tellme, Page1, "Retry")
                                SetForegroundColour ("OrangeRed")
                                SetFlagOn ("wordknowledge")
                              </script>
                            </object>
                            <object name="correctword">
                              <inherit name="scripttext" />
                              <script type="script">
                                msg ("Suddenly you catch a glimpse of utter shock on Abigail's face.")
                                msg ("Abigail: Wait, you... You guessed the word I was thinking of?")
                                msg ("Abigail : I mean sure, you said you would do that but I didn't expect for you to get it right if I'm being honest.")
                                msg ("Abigail: This all feels so surreal, I mean I'm starting to believe you but I feel like if I say I completly believe you some cameracrew will come out from their hiding spots and make fun of me for believing something so stupid.")
                                msg ("Abigail: So if I'd hypothetically believe you, what is all of this about?")
                                AddPageLink (correctword, auraofdeath, "You have an aura of death surrounding you Abigail, I'm trying to keep you safe with my powers.")
                                if (GetBoolean(game, "chinese")) {
                                  AddPageLink (correctword, datetosave, "I knew you would die on a date in a chinese restaurant because of an allergic reaction so I figured I would be your date so I would be able to warn you.")
                                  AddPageLink (correctword, justhelpingout, "Well, while you were saying you wanted to go for the Peking duck I suddenly knew there was something in it that would cause you sever allergic reactions.")
                                }
                                else if (GetBoolean(game, "burgers")) {
                                  AddPageLink (correctword, datetosave, "I knew you would die on a date in a burger restaurant because of a lost bullet so I figured I would be your date so I would be able to warn you.")
                                  AddPageLink (correctword, justhelpingout, "Well, while you were sitting there somehow I just felt that you would get shot.")
                                }
                                else if (GetBoolean(game, "cafe")) {
                                  AddPageLink (correctword, datetosave, "I knew you would die on a date in a cafe because of a shark's crushing weight so I figured I would be your date so I would be able to warn you.")
                                  AddPageLink (correctword, justhelpingout, "Well, while you were sitting there somehow I just felt that that would happen.")
                                }
                                RemovePageLink (correctword, no time to explain)
                                RemovePageLink (correctword, no time to explain)
                                RemovePageLink (correctword, no time to explain)
                                if (GetBoolean(game, "chinese")) {
                                  if (GetBoolean(game, "geeseknowledge")) {
                                    AddPageLink (correctword, no time to explain, "I have no time to explain, we need to get out of here, follow me.")
                                  }
                                }
                                else if (GetBoolean(game, "burgers")) {
                                  if (GetBoolean(game, "gasknowledge")) {
                                    AddPageLink (correctword, no time to explain, "I have no time to explain, we need to get out of here, follow me.")
                                  }
                                }
                                else if (GetBoolean(game, "cafe")) {
                                  if (GetBoolean(game, "drownkowledge")) {
                                    AddPageLink (correctword, no time to explain, "I have no time to explain, we need to get out of here, follow me.")
                                  }
                                }
                              </script>
                              <object name="auraofdeath">
                                <inherit name="scripttext" />
                                <script type="script">
                                  RemovePageLink (auraofdeath, yes I did)
                                  msg ("Abigail: An aura of death? Are you joking?")
                                  msg ("Your serious look tells Abigail you are anything but joking.")
                                  msg ("Abigail: Well, thanks for trying to save me, so far you're doing an absolutely fantastic job!")
                                  msg ("Abigail: So, do you think it is over? Did you finally stop that weird aura of death you were speaking of?")
                                  AddPageLink (auraofdeath, yes I did, "I sure did!")
                                  AddPageLink (auraofdeath, stilldying, "Actually you're still dying.")
                                </script>
                                <object name="yes I did">
                                  <inherit name="scripttext" />
                                  <script type="script">
                                    msg ("Abgail: Great, now we can just continue enjoying our date!")
                                    msg ("Abigail gives you a wide smile, you feel like you could beat the universe itself.")
                                    RemovePageLink (yes I did, Geeseatack)
                                    RemovePageLink (yes I did, gasexplosion)
                                    RemovePageLink (yes I did, death2res3)
                                    if (GetBoolean(game, "chinese")) {
                                      AddPageLink (yes I did, Geeseatack, "We actually did it, I still can't believe it!")
                                    }
                                    else if (GetBoolean(game, "burgers")) {
                                      AddPageLink (yes I did, gasexplosion, "We actually did it, I still can't believe it!")
                                    }
                                    else if (GetBoolean(game, "cafe")) {
                                      AddPageLink (yes I did, death2res3, "We actually did it, I still can't believe it!")
                                    }
                                  </script>
                                  <object name="Page6" />
                                </object>
                                <object name="you still die" />
                              </object>
                              <object name="datetosave">
                                <inherit name="scripttext" />
                                <script type="script">
                                  msg ("Abigail: Seems rather convoluted doesn't it?")
                                  msg ("Abigail: Couldn't you just have found me and told me?")
                                  if (GetBoolean(game, "chinese")) {
                                    AddPageLink (datetosave, youwouldntbel, "Oh yeah, and you would just believe a random person telling you that you will die of an allergy in a chinese restaurant on a specific day?")
                                  }
                                  else if (GetBoolean(game, "cafe")) {
                                    AddPageLink (datetosave, youwouldntbel, "Oh yeah, and you would just believe a random person telling you that you will die by being crushed by a great white shark in a fish themed cafe on a specific day?")
                                  }
                                  else if (GetBoolean(game, "burgers")) {
                                    AddPageLink (datetosave, youwouldntbel, "Oh yeah, and you would just believe a random person telling you that you will die because of a gunshot wound in a burger restaurant on a specific day?")
                                  }
                                </script>
                                <object name="youwouldntbel">
                                  <inherit name="scripttext" />
                                  <script type="script">
                                    msg ("Abigail: Hmm, you made a fair point there, even if I would have believed you I don't think I would have actually been able to remember it when I needed that knowledge.")
                                    msg ("Abigail: It still sounds like there were better, less convoluted ways to keep me from eating that Peking duck but I'm still really thankfull that you saved my life.")
                                    msg ("Abigail: We actually cheated death itself, take that death!")
                                    AddPageLink (youwouldntbel, dontteasedeath, "I think it may not be really wise to tease death itself. ")
                                    AddPageLink (youwouldntbel, take that, "Take that death, we've won, woohoo!")
                                    if (GetBoolean(game, "chinese")) {
                                      if (GetBoolean(game, "geeseknowledge")) {
                                        AddPageLink (youwouldntbel, stilldying, "Actually you're still going to die if we keep sitting here, this time by an army of angry geese.")
                                      }
                                    }
                                    else if (GetBoolean(game, "burgers")) {
                                      if (GetBoolean(game, "gasknowledge")) {
                                        AddPageLink (youwouldntbel, stilldying, "Actually you are still going to die if we keep sitting here, this time it'll be a gas explosion.")
                                      }
                                    }
                                    else if (GetBoolean(game, "cafe")) {
                                      if (GetBoolean(game, "drownknowledge")) {
                                        AddPageLink (youwouldntbel, stilldying, "Actually you are still going to drown, this time by drowning.")
                                      }
                                    }
                                  </script>
                                  <object name="dontteasedeath">
                                    <inherit name="scripttext" />
                                    <options type="stringdictionary" />
                                    <script type="script">
                                      msg ("Abigail: Common, let's celibrate, we just escaped death! Don't be so worried, what's the worst thing that could happen?")
                                      if (GetBoolean(game, "chinese")) {
                                        AddPageLink (dontteasedeath, Geeseatack, "Yeah, you're probably right. Wait, why did you say that? Now we are going to die for sure.")
                                      }
                                      else if (GetBoolean(game, "burgers")) {
                                        AddPageLink (dontteasedeath, gasexplosion, "Yeah, you're probably right. Wait, why did you say that? Now we are going to die for sure.")
                                      }
                                      else if (GetBoolean(game, "cafe")) {
                                        AddPageLink (dontteasedeath, death2res3, "Yeah, you're probably right. Wait, why did you say that? Now we are going to die for sure.")
                                      }
                                    </script>
                                  </object>
                                  <object name="take that">
                                    <inherit name="scripttext" />
                                    <script type="script">
                                      msg ("You and Abbigail high five eachotther, you've won. Congratulatons!")
                                      if (GetBoolean(game, "chinese")) {
                                        AddPageLink (take that, Geeseatack, "Yes, we've won Abigail!")
                                      }
                                      else if (GetBoolean(game, "burgers")) {
                                        AddPageLink (take that, gasexplosion, "Yes, we've won Abigail!")
                                      }
                                      else if (GetBoolean(game, "cafe")) {
                                        AddPageLink (take that, death2res3, "Yes, we've won Abigail!")
                                      }
                                    </script>
                                  </object>
                                  <object name="stillgoingtodie" />
                                </object>
                              </object>
                              <object name="justhelpingout">
                                <inherit name="scripttext" />
                                <script type="script">
                                  msg ("Abigail: Wow, that's quite the story! Luckily you somehow felt that because otherwise I'd be dead!")
                                  msg ("Abgail: So am I in the clear now?")
                                  AddPageLink (justhelpingout, Yes, "Yup, you are completly safe now!")
                                  if (GetBoolean(game, "chinese")) {
                                    if (GetBoolean(game, "geeseknowledge")) {
                                      AddPageLink (justhelpingout, stilldying, "Actually you're still going to die, this time because of a swarm of geese.")
                                    }
                                  }
                                  else if (GetBoolean(game, "burgers")) {
                                    if (GetBoolean(game, "gasknowledge")) {
                                      AddPageLink (justhelpingout, stilldying, "Actually you're still going to die, this time due to a gas leak.")
                                    }
                                  }
                                  else if (GetBoolean(game, "cafe")) {
                                    if (GetBoolean(game, "sharkknowledge")) {
                                      AddPageLink (justhelpingout, stilldying, "Actually you're still going to die, this time you'll drown.")
                                    }
                                  }
                                </script>
                                <object name="yes">
                                  <inherit name="scripttext" />
                                  <script type="script">
                                    msg ("Abigail gives you a thumbs up and plays a few notes on an air gitar.")
                                    msg ("Abigail: We actually did it, that's awesome!")
                                    if (GetBoolean(game, "chinese")) {
                                      if (GetBoolean(game, "geeseknowledge")) {
                                        AddPageLink (yes, stillgoingtodie, "Actually you're still going to die, this time because of a swarm of geese.")
                                      }
                                    }
                                    else if (GetBoolean(game, "burgers")) {
                                      if (GetBoolean(game, "gasknowledge")) {
                                        AddPageLink (yes, stillgoingtodie, "Actually you're still going to die, this time due to a gas leak.")
                                      }
                                    }
                                    else if (GetBoolean(game, "cafe")) {
                                      if (GetBoolean(game, "sharkknowledge")) {
                                        AddPageLink (yes, stillgoingtodie, "Actually you're still going to die, this time you'll drown.")
                                      }
                                    }
                                    if (GetBoolean(game, "chinese")) {
                                      AddPageLink (yes, Geeseatack, "We sure did Abby, we sure did.")
                                    }
                                    else if (GetBoolean(game, "cafe")) {
                                      AddPageLink (yes, death2res3, "We sure did Abby, we sure did.")
                                    }
                                    else if (GetBoolean(game, "burgers")) {
                                      AddPageLink (yes, gasexplosion, "We sure did Abby, we sure did.")
                                    }
                                  </script>
                                </object>
                                <object name="stilldying" />
                              </object>
                            </object>
                            <object name="word badoption1">
                              <inherit name="scripttext" />
                              <script type="script">
                                msg ("Abigail: That was the wrong word, I knew you wouldn't guess electronegativity!")
                                SetFlagOn ("wordknowledge")
                                if (GetBoolean(game, "burgers")) {
                                  SetForegroundColour ("OrangeRed")
                                  msg ("Abigail: Listen, I'm really thankful for you saving my life and everything but why are you giving me such an implausible explenation?")
                                  msg ("Abigail: I mean this is all a bit much for me, I think I'm better of heading back to home.")
                                  SetForegroundColour ("Purple")
                                  msg ("You and Abigail both leave the restaurant, but just when you set one foot outside of the doorframe a red Sedan.")
                                  msg ("Luckily you managed to get flung to the side somehow. Abigail however was not so lucky.")
                                  msg ("She died on impact when the speeding car hit her.")
                                  msg ("Atleast the drunkard who caused all of this will be locked up but you still lost Abigail.")
                                  SetFontSize (29)
                                  msg ("Game over")
                                  SetFontSize (13)
                                  msg ("Your date surely didn't go as planned.")
                                  SetFontSize (11)
                                  AddPageLink (word badoption1, Page1, "Retry")
                                  SetForegroundColour ("OrangeRed")
                                }
                                else if (GetBoolean(game, "chinese")) {
                                  SetForegroundColour ("OrangeRed")
                                  msg ("Abigail: Listen, I'm not even sure if you saved me and you also didn't give me any proof of your psychic powers, it all just seems really implausible.")
                                  msg ("Abigail: I mean this is all a bit much for me, I think I'm better of heading back to home.")
                                  SetForegroundColour ("Purple")
                                  msg ("You and Abigail both leave the restaurant, but just when you set one foot outside of the doorframe a red Sedan.")
                                  msg ("Luckily you managed to get flung to the side somehow. Abigail however was not so lucky.")
                                  msg ("She died on impact when the speeding car hit her.")
                                  msg ("Atleast the drunkard who caused all of this will be locked up but you still lost Abigail.")
                                  SetFontSize (29)
                                  msg ("Game over")
                                  SetFontSize (13)
                                  msg ("Your date surely didn't go as planned.")
                                  SetFontSize (11)
                                  AddPageLink (word badoption1, Page1, "Retry")
                                  SetForegroundColour ("OrangeRed")
                                }
                                else if (GetBoolean(game, "cafe")) {
                                  msg ("Abigail: Listen, I'm really thankful for you saving my life and everything but I don't think I can do this, I really don't believe you.")
                                  msg ("Abigail: I mean this is all a bit too much for me, I think I'm better of heading back to home.")
                                  msg ("You and Abigail both leave the restaurant, but just when you set one foot outside of the doorframe a red Sedan.")
                                  msg ("Luckily you managed to get flung to the side somehow. Abigail however was not so lucky.")
                                  msg ("She died on impact when the speeding car hit her.")
                                  msg ("Atleast the drunkard who caused all of this will be locked up but you still lost Abigail.")
                                  SetFontSize (29)
                                  msg ("Game over")
                                  SetFontSize (13)
                                  msg ("Your date surely didn't go as planned.")
                                  SetFontSize (11)
                                  AddPageLink (word badoption1, Page1, "Retry")
                                }
                              </script>
                            </object>
                            <object name="word badoption2">
                              <inherit name="scripttext" />
                              <script type="script">
                                msg ("Abigail: That was the wrong word, I knew you wouldn't guess electronegativity!")
                                SetFlagOn ("wordknowledge")
                                if (GetBoolean(game, "burgers")) {
                                  msg ("Abigail: Listen, I'm really thankful for you saving my life and everything but why are you giving me such an implausible explenation?")
                                  msg ("Abigail: I mean this is all a bit much for me, I think I'm better of heading back to home.")
                                  msg ("You and Abigail both leave the restaurant, but just when you set one foot outside of the doorframe a red Sedan.")
                                  msg ("Luckily you managed to get flung to the side somehow. Abigail however was not so lucky.")
                                  msg ("She died on impact when the speeding car hit her.")
                                  msg ("Atleast the drunkard who caused all of this will be locked up but you still lost Abigail.")
                                  SetFontSize (29)
                                  msg ("Game over")
                                  SetFontSize (13)
                                  msg ("Your date surely didn't go as planned.")
                                  SetFontSize (11)
                                  AddPageLink (word badoption2, Page1, "Retry")
                                }
                                else if (GetBoolean(game, "chinese")) {
                                  msg ("Abigail: Listen, you are aware of the fact that you didn't provide me with proof of either my supposed allergic reaction or your psychic powers right? ")
                                  msg ("Abigail: I mean this is all a bit too much for me, I think I'm better of heading back to home.")
                                  msg ("You and Abigail both leave the restaurant, but just when you set one foot outside of the doorframe a red Sedan.")
                                  msg ("Luckily you managed to get flung to the side somehow. Abigail however was not so lucky.")
                                  msg ("She died on impact when the speeding car hit her.")
                                  msg ("Atleast the drunkard who caused all of this will be locked up but you still lost Abigail.")
                                  SetFontSize (29)
                                  msg ("Game over")
                                  SetFontSize (13)
                                  msg ("Your date surely didn't go as planned.")
                                  SetFontSize (11)
                                  AddPageLink (word badoption2, Page1, "Retry")
                                }
                                else if (GetBoolean(game, "cafe")) {
                                  msg ("Abigail: Listen, I'm really thankful for you saving my life and everything but I don't think I can do this, I really don't believe you.")
                                  msg ("Abigail: I mean this is all a bit too much for me, I think I'm better of heading back to home.")
                                  msg ("You and Abigail both leave the restaurant, but just when you set one foot outside of the doorframe a red Sedan.")
                                  msg ("Luckily you managed to get flung to the side somehow. Abigail however was not so lucky.")
                                  msg ("She died on impact when the speeding car hit her.")
                                  msg ("Atleast the drunkard who caused all of this will be locked up but you still lost Abigail.")
                                  SetFontSize (29)
                                  msg ("Game over")
                                  SetFontSize (13)
                                  msg ("Your date surely didn't go as planned.")
                                  SetFontSize (11)
                                  AddPageLink (word badoption2, Page1, "Retry")
                                }
                              </script>
                            </object>
                            <object name="word badoption3">
                              <inherit name="scripttext" />
                              <script type="script">
                                msg ("Abigail: That was the wrong word, I knew you wouldn't guess electronegativity!")
                                SetFlagOn ("wordknowledge")
                                if (GetBoolean(game, "burgers")) {
                                  msg ("Abigail: Listen, I'm really thankful for you saving my life and everything but why are you giving me such an implausible explenation?")
                                  msg ("Abigail: I mean this is all a bit much for me, I think I'm better of heading back to home.")
                                  msg ("You and Abigail both leave the restaurant, but just when you set one foot outside of the doorframe a red Sedan.")
                                  msg ("Luckily you managed to get flung to the side somehow. Abigail however was not so lucky.")
                                  msg ("She died on impact when the speeding car hit her.")
                                  msg ("Atleast the drunkard who caused all of this will be locked up but you still lost Abigail.")
                                  SetFontSize (29)
                                  msg ("Game over")
                                  SetFontSize (13)
                                  msg ("Your date surely didn't go as planned.")
                                  SetFontSize (11)
                                  AddPageLink (word badoption3, Page1, "Retry")
                                }
                                else if (GetBoolean(game, "chinese")) {
                                  msg ("Abigail: Listen, you are aware of the fact that you didn't provide me with proof of either my supposed allergic reaction or your psychic powers right? ")
                                  msg ("Abigail: I mean this is all a bit too much for me, I think I'm better of heading back to home.")
                                  msg ("You and Abigail both leave the restaurant, but just when you set one foot outside of the doorframe a red Sedan.")
                                  msg ("Luckily you managed to get flung to the side somehow. Abigail however was not so lucky.")
                                  msg ("She died on impact when the speeding car hit her.")
                                  msg ("Atleast the drunkard who caused all of this will be locked up but you still lost Abigail.")
                                  SetFontSize (29)
                                  msg ("Game over")
                                  SetFontSize (13)
                                  msg ("Your date surely didn't go as planned.")
                                  SetFontSize (11)
                                  AddPageLink (word badoption3, Page1, "Retry")
                                }
                                else if (GetBoolean(game, "cafe")) {
                                  msg ("Abigail: Listen, I'm really thankful for you saving my life and everything but I don't think I can do this, I really don't believe you.")
                                  msg ("Abigail: I mean this is all a bit too much for me, I think I'm better of heading back to home.")
                                  msg ("You and Abigail both leave the restaurant, but just when you set one foot outside of the doorframe a red Sedan.")
                                  msg ("Luckily you managed to get flung to the side somehow. Abigail however was not so lucky.")
                                  msg ("She died on impact when the speeding car hit her.")
                                  msg ("Atleast the drunkard who caused all of this will be locked up but you still lost Abigail.")
                                  SetFontSize (29)
                                  msg ("Game over")
                                  SetFontSize (13)
                                  msg ("Your date surely didn't go as planned.")
                                  SetFontSize (11)
                                  AddPageLink (word badoption3, Page1, "Retry")
                                }
                              </script>
                            </object>
                            <object name="word badoption4">
                              <inherit name="scripttext" />
                              <script type="script">
                                msg ("Abigail: That was the wrong word, I knew you wouldn't guess electronegativity!")
                                SetFlagOn ("wordknowledge")
                                if (GetBoolean(game, "burgers")) {
                                  msg ("Abigail: Listen, I'm really thankful for you saving my life and everything but why are you giving me such an implausible explenation?")
                                  msg ("Abigail: I mean this is all a bit much for me, I think I'm better of heading back to home.")
                                  msg ("You and Abigail both leave the restaurant, but just when you set one foot outside of the doorframe a red Sedan.")
                                  msg ("Luckily you managed to get flung to the side somehow. Abigail however was not so lucky.")
                                  msg ("She died on impact when the speeding car hit her.")
                                  msg ("Atleast the drunkard who caused all of this will be locked up but you still lost Abigail.")
                                  SetFontSize (29)
                                  msg ("Game over")
                                  SetFontSize (13)
                                  msg ("Your date surely didn't go as planned.")
                                  SetFontSize (11)
                                  AddPageLink (word badoption4, Page1, "Retry")
                                }
                                else if (GetBoolean(game, "chinese")) {
                                  msg ("Abigail: Listen, you are aware of the fact that you didn't provide me with proof of either my supposed allergic reaction or your psychic powers right? ")
                                  msg ("Abigail: I mean this is all a bit too much for me, I think I'm better of heading back to home.")
                                  msg ("You and Abigail both leave the restaurant, but just when you set one foot outside of the doorframe a red Sedan.")
                                  msg ("Luckily you managed to get flung to the side somehow. Abigail however was not so lucky.")
                                  msg ("She died on impact when the speeding car hit her.")
                                  msg ("Atleast the drunkard who caused all of this will be locked up but you still lost Abigail.")
                                  SetFontSize (29)
                                  msg ("Game over")
                                  SetFontSize (13)
                                  msg ("Your date surely didn't go as planned.")
                                  SetFontSize (11)
                                  AddPageLink (word badoption4, Page1, "Retry")
                                }
                                else if (GetBoolean(game, "cafe")) {
                                  msg ("Abigail: Listen, I'm really thankful for you saving my life and everything but I don't think I can do this, I really don't believe you.")
                                  msg ("Abigail: I mean this is all a bit too much for me, I think I'm better of heading back to home.")
                                  msg ("You and Abigail both leave the restaurant, but just when you set one foot outside of the doorframe a red Sedan.")
                                  msg ("Luckily you managed to get flung to the side somehow. Abigail however was not so lucky.")
                                  msg ("She died on impact when the speeding car hit her.")
                                  msg ("Atleast the drunkard who caused all of this will be locked up but you still lost Abigail.")
                                  SetFontSize (29)
                                  msg ("Game over")
                                  SetFontSize (13)
                                  msg ("Your date surely didn't go as planned.")
                                  SetFontSize (11)
                                  AddPageLink (word badoption4, Page1, "Retry")
                                }
                              </script>
                            </object>
                          </object>
                        </object>
                        <object name="Game">
                          <inherit name="scripttext" />
                          <script type="script">
                            msg ("Abigail: Wait what? So you are saying we are in some sort of game right now?")
                            msg ("Abigail: I mean that could certainly be a possibility, I'm not sure if we'll ever know for sure if we're in a game or not.")
                            msg ("Abigail: I find what your saying to be rather interesting but do you have any proof as to your whole \"we're in a videogame\" story?")
                            AddPageLink (Game, think of story, "Alright, think of a story, anything will do.")
                          </script>
                          <object name="think of story">
                            <inherit name="scripttext" />
                            <script type="script">
                              SetForegroundColour ("OrangeRed")
                              msg ("Abigail: Alright, I can see where this is going, you're going to try and guess what I'm thinking of right?")
                              AddPageLink (think of story, yesguess, "Yup, you're absolutely right!")
                              AddPageLink (think of story, nope, "No, you need to tell me the story now.")
                            </script>
                            <object name="yesguess">
                              <inherit name="scripttext" />
                              <script type="script">
                                SetForegroundColour ("OrangeRed")
                                msg ("Abigail: Well best of luck, i got a pretty hard story for you to guess.")
                                SetForegroundColour ("Purple")
                                msg ("Abigail giggles for a moment and then looks at you with a sceptic look in her eyes.")
                                AddPageLink (yesguess, wrongstory, "Your story is about a girl that goes out to buy milk and gets trapped in some alternate universe that is a reflection of her mind.")
                                AddPageLink (yesguess, wrongstory1, "Your story is about about a man who has to live through an apocalypse that has been caused by strange crystals.")
                                AddPageLink (yesguess, word badoption2, "Your story is about someone who has to date parts of himself to come to terms with his bad fragments.")
                                AddPageLink (yesguess, wrongstory3, "Actually I have no clue what the story you have in mind could be.")
                                if (GetBoolean(game, "storyknowledge")) {
                                  AddPageLink (yesguess, rightstory, "Your story is about a man who meets the love of his life in a dream and spends his entire life with her only to wake up the day after he went to bed.")
                                }
                              </script>
                              <object name="wrongstory">
                                <inherit name="scripttext" />
                                <script type="script">
                                  msg ("Abigail: That was the wrong story! I knew you wouldn't guess the story would be about a guy who meets a girl in his dreams and spends his whole life with her, only to wake up a day later than he went to bed.")
                                  SetFlagOn ("storyknowledge")
                                  if (GetBoolean(game, "burgers")) {
                                    msg ("Abigail: Listen, I'm really thankful for you saving my life and everything but why are you giving me such an implausible explenation?")
                                    msg ("Abigail: I mean this is all a bit much for me, I think I'm better of heading back to home.")
                                    msg ("You and Abigail both leave the restaurant, but just when you set one foot outside of the doorframe a red Sedan.")
                                    msg ("Luckily you managed to get flung to the side somehow. Abigail however was not so lucky.")
                                    msg ("She died on impact when the speeding car hit her.")
                                    msg ("Atleast the drunkard who caused all of this will be locked up but you still lost Abigail.")
                                    SetFontSize (29)
                                    msg ("Game over")
                                    SetFontSize (13)
                                    msg ("Your date surely didn't go as planned.")
                                    SetFontSize (11)
                                    AddPageLink (wrongstory, Page1, "Retry")
                                  }
                                  else if (GetBoolean(game, "chinese")) {
                                    msg ("Abigail: Listen, you are aware of the fact that you didn't provide me with proof of either my supposed allergic reaction or your psychic powers right? ")
                                    msg ("Abigail: I mean this is all a bit too much for me, I think I'm better of heading back to home.")
                                    msg ("You and Abigail both leave the restaurant, but just when you set one foot outside of the doorframe a red Sedan.")
                                    msg ("Luckily you managed to get flung to the side somehow. Abigail however was not so lucky.")
                                    msg ("She died on impact when the speeding car hit her.")
                                    msg ("Atleast the drunkard who caused all of this will be locked up but you still lost Abigail.")
                                    SetFontSize (29)
                                    msg ("Game over")
                                    SetFontSize (13)
                                    msg ("Your date surely didn't go as planned.")
                                    SetFontSize (11)
                                    AddPageLink (wrongstory, Page1, "Retry")
                                  }
                                  else if (GetBoolean(game, "cafe")) {
                                    msg ("Abigail: Listen, I'm really thankful for you saving my life and everything but I don't think I can do this, I really don't believe you.")
                                    msg ("Abigail: I mean this is all a bit too much for me, I think I'm better of heading back to home.")
                                    msg ("You and Abigail both leave the restaurant, but just when you set one foot outside of the doorframe a red Sedan.")
                                    msg ("Luckily you managed to get flung to the side somehow. Abigail however was not so lucky.")
                                    msg ("She died on impact when the speeding car hit her.")
                                    msg ("Atleast the drunkard who caused all of this will be locked up but you still lost Abigail.")
                                    SetFontSize (29)
                                    msg ("Game over")
                                    SetFontSize (13)
                                    msg ("Your date surely didn't go as planned.")
                                    SetFontSize (11)
                                    AddPageLink (wrongstory, Page1, "Retry")
                                  }
                                </script>
                              </object>
                              <object name="rightstory">
                                <inherit name="scripttext" />
                                <script type="script">
                                  SetForegroundColour ("Purple")
                                  msg ("Abigail gasps, you can see the pure confusion in her eyes.")
                                  SetForegroundColour ("OrangeRed")
                                  msg ("Abigail: Hang on, how did you know wich story I was thinking of?")
                                  msg ("Abigail: I mean, I guess you told me you were in a game but how would you have known? ")
                                  AddPageLink (rightstory, retry saves, "I'm basically retying certain scenarios and learning things that I need to then move on.")
                                  RemovePageLink (rightstory, no time to explain)
                                  RemovePageLink (rightstory, no time to explain)
                                  RemovePageLink (rightstory, no time to explain)
                                  if (GetBoolean(game, "geeseknowledge")) {
                                    if (GetBoolean(game, "chinese")) {
                                      AddPageLink (rightstory, no time to explain, "I have no time to explain, we need to get out of here, follow me.")
                                    }
                                  }
                                  else if (GetBoolean(game, "gasknowledge")) {
                                    if (GetBoolean(game, "burgers")) {
                                      AddPageLink (rightstory, no time to explain, "I have no time to explain, we need to get out of here, follow me.")
                                    }
                                  }
                                  else if (GetBoolean(game, "drownknowledge")) {
                                    if (GetBoolean(game, "cafe")) {
                                      AddPageLink (rightstory, no time to explain, "I have no time to explain, we need to get out of here, follow me.")
                                    }
                                  }
                                </script>
                                <object name="retry saves">
                                  <inherit name="scripttext" />
                                  <script type="script">
                                    SetForegroundColour ("OrangeRed")
                                    msg ("Abigail: That would be nice wouldn't it? To just be able to retry all the things that bother us and then just solve all the problems on that front.")
                                    msg ("Abigail: Sometimes I just want to put time to a halt to live a week in a second's worth of time.")
                                    msg ("Abigail: To just be able to capture one moment and live it for as long as I would want, that seems liek a wonderfull thought doesn't it?")
                                    SetForegroundColour ("Purple")
                                    msg ("You nod at Abigail and she gives you a cute smile.")
                                    SetForegroundColour ("OrangeRed")
                                    msg ("Abigail: I knew you'd get it! ")
                                    msg ("Abigail: I think that we all have that desire, to just take a rest from the endless stream of things that life brings us.")
                                    msg ("Abigail: And in a way, you get to do just that.")
                                    msg ("Abigail: Capturing certain moments and reliving them endlessly, you really have been graced with a beautiful gift if you'd ask me.")
                                    msg ("Abigail: Even if the moments you get to relive are just part of a game, don't take it for granted.")
                                    msg ("Abigail: In the end everything is just as real as you make it.")
                                    msg ("Abigail: I hope that made some sense and sorry if I'm rambling.")
                                    AddPageLink (retry saves, rambling, "You're not rambling and you're making perfect sense.")
                                  </script>
                                  <object name="rambling">
                                    <inherit name="scripttext" />
                                    <script type="script"><![CDATA[
                                      if (GetBoolean(game, "burgers")) {
                                        msg ("Suddenly a inmense sensation of pain overwhelms you, the only thing you can see is a glimpse of pure white and an eternity of black.")
                                        msg ("When you awaken you find yourself surrounded by doctors, they tell you that with the force of sheer luck a stray bullet managed to cause a gas leak.")
                                        msg ("The gas explosion that followed was quite severe, you were in a coma and had to have your wounds cleaned with some surgical procedures.")
                                        msg ("After a week you got out of your coma, Abigail however didn't have such luck.")
                                        msg ("The doctors tell you that she atleast went out pretty quickly, almost like dying in your sleep but with more explosions.")
                                        SetFlagOn ("gasknowledge")
                                        SetFontSize (29)
                                        msg ("Game over")
                                        SetFontSize (13)
                                        msg ("Your date surely didn't go as planned.")
                                        SetFontSize (11)
                                        AddPageLink (rambling, Page1, "Retry")
                                        SetForegroundColour ("OrangeRed")
                                      }
                                      else if (GetBoolean(game, "cafe")) {
                                        SetForegroundColour ("Purple")
                                        msg ("Suddenly you hear someone scream, you can turn your head just quick enough to see someone fall with a plate in their hands.")
                                        msg ("The plate flies in the air, with it the ham sandwich that was put on top of it.")
                                        msg ("You are apparently not the only one who has noticed, as you can see a gigantic grey-ish creature jumping out from the water and lunging at the sandwich.")
                                        msg ("It takes you a second or two to realise that the creature is in fact a shark, do they keep sharks in the cafe?")
                                        msg ("You can barely get out of it's reach as it lands on the table, you get a brief glimpse of it's sheer gigantic proportions.")
                                        msg ("Abigail gets to look at the size of the great white shark a little bit closer as it completly crushes her with it's weight.")
                                        SetFontSize (29)
                                        msg ("Game over")
                                        SetFontSize (13)
                                        msg ("Your date surely didn't go as planned.")
                                        SetFlagOn ("sharkknowledge")
                                        SetFontSize (11)
                                        AddPageLink (rambling, Page1, "Retry")
                                        SetForegroundColour ("OrangeRed")
                                      }
                                      else if (GetBoolean(game, "chinese")) {
                                        SetForegroundColour ("Purple")
                                        msg ("Suddenly you are interrupted in the midle of your sentence, you hear the faint sound of quacking.")
                                        msg ("The sound of the quacking steadily grows louder and louder untill it's all you can hear.")
                                        msg ("A true quackophony if you will.")
                                        msg ("Abigail looks over your shoulder with a frightend look in her eyes.")
                                        msg ("When you turn around you see a wave of angry geese breaking through the doors of the once cozy Chinese restaurant, the staff is running around in sheer panic.")
                                        msg ("Before you can make another sound everything turns to white, the white of pesky geese feathers.")
                                        msg ("The pain you are experiencing is too much and you fall unconscious.")
                                        msg ("When you wake up again all the cutomers and staff have dissapeared, including Abigail.")
                                        msg ("The room is completly filled to the brim with geese feathers, you begin to sneeze just thinking about that.")
                                        msg ("While you are sneezing you notice that someone put a sticky note on your hand.")
                                        msg ("It reads a as following: \"We took everyone and you won't be seeing them back, let this be a lesson on why you should not eat or serve geese or ducks as those are also part of our family. <br/>- Sincerely, the geese\"")
                                        SetFontSize (29)
                                        msg ("Game over")
                                        SetFontSize (13)
                                        msg ("Your date surely didn't go as planned.")
                                        SetFlagOn ("geeseknowledge")
                                        SetFontSize (11)
                                        AddPageLink (rambling, Page1, "Retry")
                                        SetForegroundColour ("OrangeRed")
                                      }
                                    ]]></script>
                                  </object>
                                </object>
                              </object>
                              <object name="wrongstory1">
                                <inherit name="scripttext" />
                                <script type="script">
                                  msg ("Abigail: That was the wrong story! I knew you wouldn't guess the story would be about a guy who meets a girl in his dreams and spends his whole life with her, only to wake up a day later than he went to bed.")
                                  SetFlagOn ("storyknowledge")
                                  if (GetBoolean(game, "burgers")) {
                                    msg ("Abigail: Listen, I'm really thankful for you saving my life and everything but why are you giving me such an implausible explenation?")
                                    msg ("Abigail: I mean this is all a bit much for me, I think I'm better of heading back to home.")
                                    msg ("You and Abigail both leave the restaurant, but just when you set one foot outside of the doorframe a red Sedan.")
                                    msg ("Luckily you managed to get flung to the side somehow. Abigail however was not so lucky.")
                                    msg ("She died on impact when the speeding car hit her.")
                                    msg ("Atleast the drunkard who caused all of this will be locked up but you still lost Abigail.")
                                    SetFontSize (29)
                                    msg ("Game over")
                                    SetFontSize (13)
                                    msg ("Your date surely didn't go as planned.")
                                    SetFontSize (11)
                                    AddPageLink (wrongstory1, Page1, "Retry")
                                  }
                                  else if (GetBoolean(game, "chinese")) {
                                    msg ("Abigail: Listen, you are aware of the fact that you didn't provide me with proof of either my supposed allergic reaction or your psychic powers right? ")
                                    msg ("Abigail: I mean this is all a bit too much for me, I think I'm better of heading back to home.")
                                    msg ("You and Abigail both leave the restaurant, but just when you set one foot outside of the doorframe a red Sedan.")
                                    msg ("Luckily you managed to get flung to the side somehow. Abigail however was not so lucky.")
                                    msg ("She died on impact when the speeding car hit her.")
                                    msg ("Atleast the drunkard who caused all of this will be locked up but you still lost Abigail.")
                                    SetFontSize (29)
                                    msg ("Game over")
                                    SetFontSize (13)
                                    msg ("Your date surely didn't go as planned.")
                                    SetFontSize (11)
                                    AddPageLink (wrongstory1, Page1, "Retry")
                                  }
                                  else if (GetBoolean(game, "cafe")) {
                                    msg ("Abigail: Listen, I'm really thankful for you saving my life and everything but I don't think I can do this, I really don't believe you.")
                                    msg ("Abigail: I mean this is all a bit too much for me, I think I'm better of heading back to home.")
                                    msg ("You and Abigail both leave the restaurant, but just when you set one foot outside of the doorframe a red Sedan.")
                                    msg ("Luckily you managed to get flung to the side somehow. Abigail however was not so lucky.")
                                    msg ("She died on impact when the speeding car hit her.")
                                    msg ("Atleast the drunkard who caused all of this will be locked up but you still lost Abigail.")
                                    SetFontSize (29)
                                    msg ("Game over")
                                    SetFontSize (13)
                                    msg ("Your date surely didn't go as planned.")
                                    SetFontSize (11)
                                    AddPageLink (wrongstory1, Page1, "Retry")
                                  }
                                </script>
                              </object>
                              <object name="wrongstory2">
                                <inherit name="scripttext" />
                                <script type="script">
                                  msg ("Abigail: That was the wrong story! I knew you wouldn't guess the story would be about a guy who meets a girl in his dreams and spends his whole life with her, only to wake up a day later than he went to bed.")
                                  SetFlagOn ("storyknowledge")
                                  if (GetBoolean(game, "burgers")) {
                                    msg ("Abigail: Listen, I'm really thankful for you saving my life and everything but why are you giving me such an implausible explenation?")
                                    msg ("Abigail: I mean this is all a bit much for me, I think I'm better of heading back to home.")
                                    msg ("You and Abigail both leave the restaurant, but just when you set one foot outside of the doorframe a red Sedan.")
                                    msg ("Luckily you managed to get flung to the side somehow. Abigail however was not so lucky.")
                                    msg ("She died on impact when the speeding car hit her.")
                                    msg ("Atleast the drunkard who caused all of this will be locked up but you still lost Abigail.")
                                    SetFontSize (29)
                                    msg ("Game over")
                                    SetFontSize (13)
                                    msg ("Your date surely didn't go as planned.")
                                    SetFontSize (11)
                                    AddPageLink (wrongstory2, Page1, "Retry")
                                  }
                                  else if (GetBoolean(game, "chinese")) {
                                    msg ("Abigail: Listen, you are aware of the fact that you didn't provide me with proof of either my supposed allergic reaction or your psychic powers right? ")
                                    msg ("Abigail: I mean this is all a bit too much for me, I think I'm better of heading back to home.")
                                    msg ("You and Abigail both leave the restaurant, but just when you set one foot outside of the doorframe a red Sedan.")
                                    msg ("Luckily you managed to get flung to the side somehow. Abigail however was not so lucky.")
                                    msg ("She died on impact when the speeding car hit her.")
                                    msg ("Atleast the drunkard who caused all of this will be locked up but you still lost Abigail.")
                                    SetFontSize (29)
                                    msg ("Game over")
                                    SetFontSize (13)
                                    msg ("Your date surely didn't go as planned.")
                                    SetFontSize (11)
                                    AddPageLink (wrongstory2, Page1, "Retry")
                                  }
                                  else if (GetBoolean(game, "cafe")) {
                                    msg ("Abigail: Listen, I'm really thankful for you saving my life and everything but I don't think I can do this, I really don't believe you.")
                                    msg ("Abigail: I mean this is all a bit too much for me, I think I'm better of heading back to home.")
                                    msg ("You and Abigail both leave the restaurant, but just when you set one foot outside of the doorframe a red Sedan.")
                                    msg ("Luckily you managed to get flung to the side somehow. Abigail however was not so lucky.")
                                    msg ("She died on impact when the speeding car hit her.")
                                    msg ("Atleast the drunkard who caused all of this will be locked up but you still lost Abigail.")
                                    SetFontSize (29)
                                    msg ("Game over")
                                    SetFontSize (13)
                                    msg ("Your date surely didn't go as planned.")
                                    SetFontSize (11)
                                    AddPageLink (wrongstory2, Page1, "Retry")
                                  }
                                </script>
                              </object>
                              <object name="wrongstory3">
                                <inherit name="scripttext" />
                                <script type="script">
                                  msg ("Abigail: I knew you wouldn't guess the story would be about a guy who meets a girl in his dreams and spends his whole life with her, only to wake up a day later than he went to bed.")
                                  SetFlagOn ("storyknowledge")
                                  if (GetBoolean(game, "burgers")) {
                                    msg ("Abigail: Listen, I'm really thankful for you saving my life and everything but why are you giving me such an implausible explenation?")
                                    msg ("Abigail: I mean this is all a bit much for me, I think I'm better of heading back to home.")
                                    msg ("You and Abigail both leave the restaurant, but just when you set one foot outside of the doorframe a red Sedan.")
                                    msg ("Luckily you managed to get flung to the side somehow. Abigail however was not so lucky.")
                                    msg ("She died on impact when the speeding car hit her.")
                                    msg ("Atleast the drunkard who caused all of this will be locked up but you still lost Abigail.")
                                    SetFontSize (29)
                                    msg ("Game over")
                                    SetFontSize (13)
                                    msg ("Your date surely didn't go as planned.")
                                    SetFontSize (11)
                                    AddPageLink (wrongstory3, Page1, "Retry")
                                  }
                                  else if (GetBoolean(game, "chinese")) {
                                    msg ("Abigail: Listen, you are aware of the fact that you didn't provide me with proof of either my supposed allergic reaction or your psychic powers right? ")
                                    msg ("Abigail: I mean this is all a bit too much for me, I think I'm better of heading back to home.")
                                    msg ("You and Abigail both leave the restaurant, but just when you set one foot outside of the doorframe a red Sedan.")
                                    msg ("Luckily you managed to get flung to the side somehow. Abigail however was not so lucky.")
                                    msg ("She died on impact when the speeding car hit her.")
                                    msg ("Atleast the drunkard who caused all of this will be locked up but you still lost Abigail.")
                                    SetFontSize (29)
                                    msg ("Game over")
                                    SetFontSize (13)
                                    msg ("Your date surely didn't go as planned.")
                                    SetFontSize (11)
                                    AddPageLink (wrongstory3, Page1, "Retry")
                                  }
                                  else if (GetBoolean(game, "cafe")) {
                                    msg ("Abigail: Listen, I'm really thankful for you saving my life and everything but I don't think I can do this, I really don't believe you.")
                                    msg ("Abigail: I mean this is all a bit too much for me, I think I'm better of heading back to home.")
                                    msg ("You and Abigail both leave the restaurant, but just when you set one foot outside of the doorframe a red Sedan.")
                                    msg ("Luckily you managed to get flung to the side somehow. Abigail however was not so lucky.")
                                    msg ("She died on impact when the speeding car hit her.")
                                    msg ("Atleast the drunkard who caused all of this will be locked up but you still lost Abigail.")
                                    SetFontSize (29)
                                    msg ("Game over")
                                    SetFontSize (13)
                                    msg ("Your date surely didn't go as planned.")
                                    SetFontSize (11)
                                    AddPageLink (wrongstory3, Page1, "Retry")
                                  }
                                </script>
                              </object>
                            </object>
                            <object name="nope">
                              <inherit name="scripttext" />
                              <script type="script">
                                SetForegroundColour ("OrangeRed")
                                msg ("Abigail: Uhm, alright, but that defeats the purpose of the story doesn't it? My story is about a guy who meets a girl in his dreams and spends his whole life with her, only to wake up a day later than he went to bed.")
                                msg ("Abigail: Listen, I'm really thankful for you saving my life and everything but I think you could atleast give me some semblance of an explanation.")
                                msg ("Abigail: This is all a bit much for me, I think I'm better of heading back to home.")
                                SetForegroundColour ("Purple")
                                msg ("You and Abigail both leave the restaurant, but just when you set one foot outside of the doorframe a red Sedan drives head first into the both of you.")
                                msg ("Luckily you managed to get flung to the side somehow. Abigail however was not so lucky.")
                                msg ("She died on impact when the speeding car hit her.")
                                msg ("Atleast the drunkard who caused all of this will be locked up but you still lost Abigail.")
                                SetFontSize (29)
                                msg ("Game over")
                                SetFontSize (13)
                                msg ("Your date surely didn't go as planned.")
                                SetFontSize (11)
                                AddPageLink (nope, Page1, "Retry")
                                SetForegroundColour ("OrangeRed")
                                SetFlagOn ("storyknowledge")
                              </script>
                            </object>
                          </object>
                        </object>
                      </object>
                    </object>
                  </object>
                </object>
                <object name="Writer">
                  <inherit name="scripttext" />
                  <script type="script">
                    msg ("Abigail: You like to write? That's pretty cool! ")
                    msg ("Abigail: I used to write some bad poems when I was a bit younger, do you want to hear one?")
                    AddPageLink (Writer, Yes, "Sure, sounds fun!")
                    AddPageLink (Writer, No, "Honestly, I'd rather not.")
                    AddPageLink (Writer, Maybe, "Hmm, i'm not quite sure.")
                  </script>
                </object>
              </object>
              <object name="remain silent">
                <inherit name="scripttext" />
                <script type="script">
                  SetForegroundColour ("Purple")
                  msg ("You both remain silent for what seems like ages while you poke your burger.")
                  msg ("You desperatly try to come up with something to break the silence.")
                  SetForegroundColour ("OrangeRed")
                  msg ("Abigail: Oh, I forgot to ask, what do you actually do for a living?")
                  AddPageLink (remain silent, Writer, "I'm an aspiring writer looking for a golden opportunity.")
                  AddPageLink (remain silent, Unemployed, "I'm currently unemployed but I sure like to write!")
                </script>
              </object>
            </object>
            <object name="fish burger">
              <inherit name="scripttext" />
              <script type="script">
                SetForegroundColour ("Purple")
                msg ("Your meal finally arrives, you and Abigail both eat like you haven't eaten in weeks.")
                msg ("After having eaten half of her cheeseburger Abigail stops for a moment. She puts her burger back in the little plastic box it was in and looks down at the floor before looking back to you again.")
                SetForegroundColour ("OrangeRed")
                msg ("Abigail: You know, my brother would absolutely love it here. He loved to be surrounded by people in places full of good ambience and like any kid he loved burgers.")
                AddPageLink (fish burger, remain silent, "*Remain silent*")
                AddPageLink (fish burger, ask brother, "What happend to your  brother?")
              </script>
            </object>
            <object name="veggie burger">
              <inherit name="scripttext" />
              <script type="script">
                SetForegroundColour ("Purple")
                msg ("Your meal finally arrives, you and Abigail both eat like you haven't eaten in weeks.")
                msg ("After having eaten half of her cheeseburger Abigail stops for a moment. She puts her burger back in the little plastic box it was in and looks down at the floor before looking back to you again.")
                SetForegroundColour ("OrangeRed")
                msg ("Abigail: You know, my brother would absolutely love it here. He loved to be surrounded by people in places full of good ambience and like any kid he loved burgers.")
                AddPageLink (veggie burger, remain silent, "*Remain silent*")
                AddPageLink (veggie burger, ask brother, "What happend to your  brother?")
              </script>
            </object>
            <object name="cheeseburger">
              <inherit name="scripttext" />
              <script type="script">
                SetForegroundColour ("Purple")
                msg ("Your meal finally arrives, you and Abigail both eat like you haven't eaten in weeks.")
                msg ("After having eaten half of her cheeseburger Abigail stops for a moment. She puts her burger back in the little plastic box it was in and looks down at the floor before looking back to you again.")
                SetForegroundColour ("OrangeRed")
                msg ("Abigail: You know, my brother would absolutely love it here. He loved to be surrounded by people in places full of good ambience and like any kid he loved burgers.")
                AddPageLink (cheeseburger, remain silent, "*Remain silent*")
                AddPageLink (cheeseburger, ask brother, "What happend to your  brother?")
              </script>
            </object>
          </object>
          <object name="showup burgers">
            <inherit name="scripttext" />
            <script type="script">
              SetForegroundColour ("Purple")
              msg ("Abigail cracks a smile at you.")
              SetForegroundColour ("OrangeRed")
              msg ("Abigail: Can't say no to burgers eh?")
              SetForegroundColour ("Purple")
              msg ("You nod while you grin as wide as you can.")
              SetForegroundColour ("OrangeRed")
              msg ("Abigail:  So, wich burger are you choosing? I'm going for the juicy cheeseburger!")
              AddPageLink (showup burgers, veggie burger, "I could go for a veggie burger!")
              AddPageLink (showup burgers, cheeseburger, "Hmm, that juicy cheesburger sounds really good!")
              AddPageLink (showup burgers, fish burger, "I think I'll pick a fish burger.")
              AddPageLink (showup burgers, beef burger, "A beef burger sounds good.")
            </script>
          </object>
        </object>
        <object name="Chinese">
          <inherit name="scripttext" />
          <script type="script">
            msg ("Abigail: That sounds like a plan!")
            msg ("Abigail: See you there.")
            SetForegroundColour ("Purple")
            msg ("You head to the Chinese restaurant, when you arive there Abigail is already seated. She happily waves at you.")
            SetForegroundColour ("OrangeRed")
            msg ("Abigail: Heya, glad you could make it!")
            AddPageLink (Chinese, cantsayno, "I can't say no to the chance of some good food!")
            SetFlagOn ("chinese")
          </script>
          <object name="cantsayno">
            <inherit name="scripttext" />
            <script type="script">
              msg ("Abigail: I love the enthusiasm! ")
              msg ("Abigail: I'm glad you choose to go to this place, there is something about the atmosphere that makes me feel really... cozy if that's the right way to say it.")
              SetForegroundColour ("Purple")
              msg ("Abigail chuckles for a moment.")
              SetForegroundColour ("OrangeRed")
              msg ("Abigail: Sorry, it's been a while since I actually did something like this.  I'm usually just having a good time on my own.")
              msg ("Abigail: But I got to say I'm really enjoying this moment we're having.")
              msg ("Abigail: I think I'd starve if I don't eat soon so let's continue our little chat while we eat. ")
              SetForegroundColour ("Purple")
              msg ("Abigail gives you a wide smile before she starts signaling the waitress.")
              SetForegroundColour ("OrangeRed")
              msg ("Abigail: I think I'll go for the Peking duck, what do you want to pick?")
              AddPageLink (cantsayno, Peking duck, "Hmm, I think I'll pick the Peking duck aswell.")
              AddPageLink (cantsayno, orange chicken, "Some orange chicken sure sounds good!")
              if (GetBoolean(game, "allergyknowledge")) {
                AddPageLink (cantsayno, shootingsaved, "Actually, don't take the Peking duck, you would react pretty bad to something that's in it.")
              }
            </script>
            <object name="Peking duck">
              <inherit name="scripttext" />
              <script type="script">
                SetForegroundColour ("Purple")
                msg ("Abigail gives you a big thumbs up as the waitress wanders of after writing down your choices.")
                msg ("When the waitress arives with your double plates of Peking duck you and Abigail immediately dig in.")
                msg ("Abigail takes a break from her food and looks at you for a moment.")
                SetForegroundColour ("OrangeRed")
                msg ("Abigail: You know, I'm actually glad we could meet here, I wanted to tell you something.")
                SetForegroundColour ("Purple")
                msg ("Before Abigail can finish her sentence her face starts to swell,")
                SetForegroundColour ("OrangeRed")
                msg ("Abigail: Call an ambulance, now!")
                SetForegroundColour ("Purple")
                msg ("You grab your phone as you frantially start calling an ambulance.")
                msg ("A woman with a warm voice listens to your incoherent ramblings and tries her best to get the details, she sends an ambulance your way.")
                msg ("The ambulance arrives quite fast but not fast enough. The doctors conclude that it must have been some sort of severe allergic reaction that made her face swell untill she couldn't breathe anymore.")
                SetFontSize (29)
                msg ("Game over")
                SetFontSize (13)
                msg ("Your date surely didn't go as planned.")
                SetFlagOn ("allergyknowledge")
                SetFontSize (11)
                AddPageLink (Peking duck, Page1, "Retry")
              </script>
            </object>
            <object name="orange chicken">
              <inherit name="scripttext" />
              <script type="script">
                SetForegroundColour ("Purple")
                msg ("Abigail gives you a big thumbs up as the waitress wanders of after writing down your choices.")
                msg ("When the waitress arives with your delicous looking food you and Abigail immediately dig in.")
                msg ("Abigail takes a break from her food and looks at you for a moment.")
                SetForegroundColour ("OrangeRed")
                msg ("Abigail: You know, I'm actually glad we could meet here, I wanted to tell you something.")
                SetForegroundColour ("Purple")
                msg ("Before Abigail can finish her sentence her face starts to swell,")
                SetForegroundColour ("OrangeRed")
                msg ("Abigail: Call an ambulance, now!")
                SetForegroundColour ("Purple")
                msg ("You grab your phone as you frantially start calling an ambulance.")
                msg ("A woman with a warm voice listens to your incoherent ramblings and tries her best to get the details, she sends an ambulance your way.")
                msg ("The ambulance arrives quite fast but not fast enough. The doctors conclude that it must have been some sort of severe allergic reaction that made her face swell untill she couldn't breathe anymore.")
                SetFontSize (29)
                msg ("Game over")
                SetFontSize (13)
                msg ("Your date surely didn't go as planned.")
                SetFlagOn ("allergyknowledge")
                SetFontSize (11)
                AddPageLink (orange chicken, Page1, "Retry")
              </script>
            </object>
          </object>
          <object name="Geeseatack">
            <inherit name="scripttext" />
            <script type="script"><![CDATA[
              SetForegroundColour ("Purple")
              msg ("Suddenly you are interrupted in the midle of your sentence, you hear the faint sound of quacking.")
              msg ("The sound of the quacking steadily grows louder and louder untill it's all you can hear.")
              msg ("A true quackophony if you will.")
              msg ("Abigail looks over your shoulder with a frightend look in her eyes.")
              msg ("When you turn around you see a wave of angry geese breaking through the doors of the once cozy Chinese restaurant, the staff is running around in sheer panic.")
              msg ("Before you can make another sound everything turns to white, the white of pesky geese feathers.")
              msg ("The pain you are experiencing is too much and you fall unconscious.")
              msg ("When you wake up again all the cutomers and staff have dissapeared, including Abigail.")
              msg ("The room is completly filled to the brim with geese feathers, you begin to sneeze just thinking about that.")
              msg ("While you are sneezing you notice that someone put a sticky note on your hand.")
              msg ("It reads a as following: \"We took everyone and you won't be seeing them back, let this be a lesson on why you should not eat or serve geese or ducks as those are also part of our family. <br/>- Sincerely, the geese\"")
              SetFontSize (29)
              msg ("Game over")
              SetFontSize (13)
              msg ("Your date surely didn't go as planned.")
              SetFlagOn ("geeseknowledge")
              SetFontSize (11)
              AddPageLink (Geeseatack, Page1, "Retry")
              SetForegroundColour ("OrangeRed")
            ]]></script>
            <object name="add page" />
          </object>
          <object name="allergywarn">
            <inherit name="scripttext" />
            <script type="script">
            </script>
          </object>
        </object>
        <object name="other date">
          <inherit name="scripttext" />
          <script type="script">
            msg ("Abigail: Wait, it was your idea to go on a dinner date?")
            msg ("Abgiail: Besides I'm quite hungry, can't we first go to a restaurant and then take a walk? That way we have the best of both worlds!")
            AddPageLink (other date, sure, "Sure, that sounds like a great idea!")
            AddPageLink (other date, import, "No, we can't go to a restaurant.")
          </script>
          <object name="sure">
            <inherit name="scripttext" />
            <script type="script">
              msg ("Abigial: Alrighty, that's a deal then!")
              msg ("Abigail: To wich restaurant do you want to go?")
              AddPageLink (sure, Burgers, "Do burgers sound good?")
              AddPageLink (sure, Chinese, "Hmm, I could go for some Chinese food.")
            </script>
          </object>
          <object name="import">
            <inherit name="scripttext" />
            <script type="script">
              msg ("Abgail: Hmm what are you saying? Why are you so concerned with us going to a restaurant, it's not like it's going to kill us silly.")
              AddPageLink (import, it will, "Actually it will, or it will kill you atleast.")
              AddPageLink (import, I was just messing with you, "Sorry, I was just messing with you.")
              if (GetBoolean(game, "Dumboknowledge")) {
                AddPageLink (import, Iknowaboutyourallergy, "I know about that one time when you thought you were Dumbo while suffering an allergic reaction.")
              }
              if (GetBoolean(game, "brotherknowledge")) {
                AddPageLink (import, iknowaboutyourbrother, "I know about your dead brother.")
              }
              if (GetBoolean(game, "startknowledge")) {
                if (GetBoolean(game, "middleknowledge")) {
                  if (GetBoolean(game, "endknowledge")) {
                    AddPageLink (import, tell the untold story, "I know about your untold story.")
                  }
                }
              }
              if (GetBoolean(game, "kakknowledge")) {
                AddPageLink (import, Kakarikowoods, "No time to explain, meet me at the Kakariko woods.")
              }
            </script>
            <object name="it will">
              <inherit name="scripttext" />
              <script type="script">
                SetForegroundColour ("OrangeRed")
                msg ("Abigail: Wait so you are saying that I will get killed if I go on a date with you?")
                msg ("Abigail: Is this some sick prank?")
                msg ("Abigail: You know, I was looking forward to our date but now I'm not anymore.")
                msg ("Abigail: Don't talk to me ever again.")
                SetForegroundColour ("Purple")
                msg ("As Abigail hangs up her phone you turn on the tv in frustration.")
                msg ("The news is on apparently, it's talking about a plane that had lost height just a moment ago")
                msg ("The plane crashed right in the living room of a nice looking house, the house doesn't look unfamilliar to you at all.")
                msg ("Then it hits you.")
                msg ("It's her house.")
                SetFontSize (29)
                msg ("Game over")
                SetFontSize (13)
                msg ("Your date surely didn't go as planned.")
                SetFlagOn ("planeknowledge")
                SetFontSize (11)
                AddPageLink (it will, Page1, "Retry")
                SetFlagOn ("liarknowledge")
              </script>
            </object>
            <object name="I was just messing with you">
              <inherit name="scripttext" />
              <script type="script">
                msg ("Abigail: Oh, I thought you were serious for a second, you sure got me!")
                msg ("Abigail: So wich restaurant do you want to choose?")
                AddPageLink (I was just messing with you, Burgers, "Do burgers sound good?")
                AddPageLink (I was just messing with you, Chinese, "Hmm, I could go for some Chinese food.")
              </script>
            </object>
            <object name="simplest I can put it" />
            <object name="want to live" />
            <object name="iknowaboutyourbrother">
              <inherit name="scripttext" />
              <script type="script">
                SetForegroundColour ("OrangeRed")
                msg ("Abigail: That's a pretty weird thing to bring up right now isn't it?")
                msg ("Abigail: I still miss him very much and-")
                msg ("Abigail: Hang on, how did you even know that? It's not like my family has been spreading the news ever since they moved.")
                msg ("Abigail: Have you... Have you been stalking me?")
                msg ("Abigail: I'm sorry, I have no interest in dating a stalker, don't call me again or I'll have to get the police involved.")
                SetForegroundColour ("Purple")
                msg ("As Abigail hangs up her phone you turn on the tv in frustration.")
                msg ("The news is on apparently, it's talking about a plane that had lost height just a moment ago")
                msg ("The plane crashed right in the living room of a nice looking house, the house doesn't look unfamilliar to you at all.")
                msg ("Then it hits you.")
                msg ("It's her house.")
                SetFontSize (29)
                msg ("Game over")
                SetFontSize (13)
                msg ("Your date surely didn't go as planned.")
                SetFlagOn ("planeknowledge")
                SetFontSize (11)
                AddPageLink (iknowaboutyourbrother, Page1, "Retry")
                SetFlagOn ("liarknowledge")
              </script>
            </object>
            <object name="Iknowaboutyourallergy">
              <inherit name="scripttext" />
              <script type="script">
                SetForegroundColour ("OrangeRed")
                msg ("Abigail: Hmm, that could be quite possible, my parents told the story to almost everyone they know, it might have spread around more than I would have realised.")
                msg ("Abigail: I'm not quite sure why you're bringing that up actually but nevermind, where would you like to eat for dinner?")
                AddPageLink (Iknowaboutyourallergy, Burgers, "Do burgers sound good?")
                AddPageLink (Iknowaboutyourallergy, Chinese, "Hmm, I could go for some Chinese food.")
                AddPageLink (Iknowaboutyourallergy, cafe, "Hmm, I think I'd like to go to the cafe.")
              </script>
            </object>
            <object name="untold story">
              <inherit name="scripttext" />
              <script type="script">
                RemovePageLink (untold story, death2res3)
                RemovePageLink (untold story, Geeseatack)
                RemovePageLink (untold story, gasexplosion)
                if (GetBoolean(game, "cafe")) {
                  SetForegroundColour ("OrangeRed")
                  msg ("Abigail: Once upon a time there was a world, but the world doesn't concern this story.")
                  msg ("Abigail: For the story we need to look high in the inkfilled sea some like to call the night.")
                  msg ("Abigail: floating in that sea is the majestic moon herself who guides us through the night and turns gold to silver, confidence to elegance.")
                  msg ("")
                  msg ("Abigail: That's the end of this part of the story, like I said you are the only person I've ever told this to so I hope you'll make good use out of it.")
                  AddPageLink (untold story, death2res3, "I sure will! ")
                  SetFlagOn ("startknowledge")
                }
                else if (GetBoolean(game, "chinese")) {
                  SetForegroundColour ("OrangeRed")
                  msg ("Abigail: The majestic moon is far from alone though, in the dark she is kept company by a thousand stars tha shine almost as bright as herself and one special raven with a silver crown.")
                  msg ("Abigail: The little raven was a prince, his parents ruled their raven-kingdom on a nice looking kind throne carved out from the wood of an oak.")
                  msg ("Abigail: The prince would one day inherit the throne but he still felt sad somehow. That was untill he noticed a silver light reflecting from his crown as he was between waking and dreams.")
                  msg ("")
                  AddPageLink (untold story, Geeseatack, "I sure will! ")
                  SetFlagOn ("middleknowledge")
                }
                else if (GetBoolean(game, "burgers")) {
                  SetForegroundColour ("OrangeRed")
                  msg ("Abigail: The raven looked up and noticed the shining moon and from that day on he never left her side.")
                  msg ("Abigail: They talk for hours, about everything and nothing. When the night would end in one part of the world the raven would follow the moon to another.")
                  msg ("Abigail: To this day you can still clearly see them when they come visit you.")
                  msg ("Abigail: The end.")
                  msg ("")
                  AddPageLink (untold story, gasexplosion, "I sure will! ")
                  SetFlagOn ("endknowledge")
                }
              </script>
            </object>
            <object name="tell the untold story">
              <inherit name="scripttext" />
              <script type="script">
                SetForegroundColour ("Purple")
                msg ("You tell Abigail her untold story that now actually is told if you think about it.")
                msg ("Throughout the entire story Abigail stayed extremely silent.")
                msg ("When you are finished you can hear her soft sobbing through the speaker of your phone.")
                SetForegroundColour ("OrangeRed")
                msg ("Abigail: Sorry, I am a bit overwhelmed, just give me a quick minute to calm myself down.")
                SetForegroundColour ("Purple")
                msg ("After five minutes you begin to hear commotion on the other side of the phone call again.")
                SetForegroundColour ("OrangeRed")
                msg ("Abigail: That story, I've never told it to anyone, I haven't even written that down, I just kept repeating it over and over in my mind.")
                msg ("Abigail: I wrote it for my brother but he never came home since then. You see, a truck and...")
                SetForegroundColour ("Purple")
                msg ("Abigail begins to sob again, this time louder.")
                SetForegroundColour ("OrangeRed")
                msg ("Abigail: I'm sorry, I can't say it, eve after all those years I just can't.")
                msg ("Abigail: Anyway, how did you even know that story, like I said earlier, I haven't shared it with anyone else and never written it down, it exist solely in my mind and I guess yours aswell now.")
                SetForegroundColour ("Purple")
                msg ("You tell Abigail about the many dates you've had together and the groundhog-esque scenario you are trapped in.")
                msg ("About a few of the different deaths she's suffered but try to not make your descriptions too gruesome.")
                msg ("About all the experiences the both of you shared, some better than others.")
                msg ("About the restaurants you've been to together.")
                msg ("That you tried to warn her to not go to one of those restaurants but that she didn't trust you.")
                msg ("That a version of her from the future, or maybe a parallel timeline that diverted in a different dirrection, helped you and told you the story, broken down in three parts, one for each restaurant.")
                msg ("Abigail coughs for a second.")
                SetForegroundColour ("OrangeRed")
                msg ("Abigail: Hold on, this is a bit much, can we meet somewhere?")
                msg ("Abigail: I got the perfect place in mind, it's a forest near the village where all three of those restaurants you just mentioned are, as a kid i called it Kakariko forrest as a refference to a game I liked to play.")
                msg ("Abigail: If I die on you again just mention Kakariko forrest, that should pique past me's interest.")
                SetFlagOn ("kakknowledge")
                msg ("Here Abigail dies once more, I still got to implement the death into the game.")
                AddPageLink (tell the untold story, Page1, "Retry")
              </script>
            </object>
            <object name="Kakarikowoods">
              <inherit name="scripttext" />
              <description type="string"></description>
              <script type="script"><![CDATA[
                SetForegroundColour ("Purple")
                msg ("Abigail gasps for a second.")
                SetForegroundColour ("OrangeRed")
                msg ("Abigail: You mean the Kakariko woods? The same as I am thinking of right now?<br/>")
                msg ("Abigail: You know what, let's both go to Kakariko woods, if we are at the same spot then I'll know for sure.")
                msg ("Abigail: While you're at it, try taking some food you got laying around your house with you, we can make a picknick date out of it!")
                SetForegroundColour ("Purple")
                msg ("Abigail giggles.")
                SetForegroundColour ("OrangeRed")
                msg ("Abigail: See you there! Or so I hope.")
                SetForegroundColour ("Purple")
                msg ("Abigail hangs up the phone and you immediatly start seeking every nook and cranny of your house for something that would make for good food on a picknick.")
                msg ("When you're done you drive to the Kakariko woods, hoping that things will be different there.")
                msg ("The woods are located on top of a hill, from where you are now standing you can see most of the village where all your past dates took place.")
                SetForegroundColour ("OrangeRed")
                msg ("Abigail: Oh hey, I see you already found a place with a good view, nice work!")
                SetForegroundColour ("Purple")
                msg ("Abigail gives you a playful pat on the back as she places her picknick blanket down on the ground.")
                msg ("Abigail and you start placing down all the food on the blanket, when you're both finished you sit down on it.")
                SetForegroundColour ("OrangeRed")
                msg ("Abigail: You know, this is really a beautiful view of the village we've got from here...")
                msg ("Abigail: But how did you know about this place? I always gave it that name when I was a kid but I never told anyone.")
                msg ("Abigail: What's all of this about?")
                AddPageLink (Kakarikowoods, kakgroundhog, "I'm in some sort of groundhog day scenario , a groundhog date if you will.")
                AddPageLink (Kakarikowoods, kakpsychic, "I'm psychic, I can predict things like kakariko woods.")
                AddPageLink (Kakarikowoods, kakgame, "You're part of a game, I've been on many dates with you in other playthroughs of this game.")
                SetFlagOn ("kakariko")
              ]]></script>
              <object name="kakpsychic">
                <inherit name="scripttext" />
                <script type="script">
                  SetForegroundColour ("Purple")
                  msg ("Abigail watches you with a sceptic look in her eyes.")
                  SetForegroundColour ("OrangeRed")
                  msg ("Abigail: You know, when you told me that story over the phone I might have believed you but now I somehow can tell you're not telling the truth if that makes sense.")
                  msg ("Abigail: So what is this all really about?")
                  AddPageLink (kakpsychic, kakgroundhog, "I'm in some sort of groundhog day scenario , a groundhog date if you will.")
                  AddPageLink (kakpsychic, kakpsychic, "I'm psychic, I can predict things like the kakariko woods.")
                  AddPageLink (kakpsychic, kakgame, "You're part of a game, I've been on many dates with you in other playthroughs of this game.")
                </script>
              </object>
              <object name="kakgame">
                <inherit name="scripttext" />
                <script type="script">
                  SetForegroundColour ("Purple")
                  msg ("Abigail shifts her position for a moment and gives you an honest smile.")
                  SetForegroundColour ("OrangeRed")
                  msg ("Abigail: That actually makes quite a bit of sense, It wouldn't be too impossible to make a game and let every character in it believe that they are real, in fact that's most games isn't it?")
                  msg ("Abigail: Most characters never break forth walls, nowadays it seems to be more and more popular but most game designers try to not make the experience shatter your immersion too much.")
                  msg ("Abigail: So, are you the one who is playing this game?")
                  AddPageLink (kakgame, itsme, "Yup, I am the one who is playing it.")
                  AddPageLink (kakgame, whoisplayiing, "I'm playing this game, although someone else might be playing with my character in another game.")
                  AddPageLink (kakgame, talkthroughcharacter, "I am, however I can't say whatever I want, I can only speak with you through these clickable links that have a preview of what I'm going to say. So in a sense I guess I'm not really playing this game, not the me you know anyway.")
                </script>
                <object name="itsme">
                  <inherit name="scripttext" />
                  <script type="script">
                    SetForegroundColour ("OrangeRed")
                    msg ("Abigail: It's pretty strange to be told that you're in a game but I'm glad you are the player, you seem more than capable enough to do what you need to do.")
                    SetForegroundColour ("Purple")
                    msg ("Abigail pauses for a moment and then continues.")
                    SetForegroundColour ("OrangeRed")
                    msg ("Abigail: Now that I think about it, what is it you've got to do in this game?")
                    AddPageLink (itsme, Me no know, "I actually have no idea.")
                  </script>
                  <object name="Me no know">
                    <inherit name="scripttext" />
                    <script type="script">
                      SetForegroundColour ("OrangeRed")
                      msg ("Abigail: That's fine, we can figure your goal out together.")
                      SetForegroundColour ("Purple")
                      msg ("Abigail scratches her chin and continues.")
                      SetForegroundColour ("OrangeRed")
                      msg ("Abigail: Let's see, first of, how does this game look to you?")
                      AddPageLink (Me no know, clickable thinks, "I just see text on the screen, your text is a different color from the narator's. I also get a few clickable links to selct what I want to say.")
                    </script>
                    <object name="clickable thinks">
                      <inherit name="scripttext" />
                      <script type="script">
                        SetForegroundColour ("OrangeRed")
                        msg ("Abigail: Ah I see, so you can't see the absolutely stunning view from our picknickspot?")
                        AddPageLink (clickable thinks, yup, "Yup, the best thing I can get is a description of it if the game feels like giving me one.")
                      </script>
                      <object name="yup">
                        <inherit name="scripttext" />
                        <script type="script">
                          SetForegroundColour ("OrangeRed")
                          msg ("Abigail: Hmm, let's try looking at the scenery, maybe the game will give you a description then.")
                          AddPageLink (yup, scenery forrest, "Sure, I'm looking forward to watch it together!")
                        </script>
                        <object name="scenery forrest">
                          <inherit name="scripttext" />
                          <script type="script">
                            SetForegroundColour ("Purple")
                            msg ("From the spot you picked on the hill you have a gorgeous view of the village where most of your dates with Abigail took place.")
                            msg ("It's pretty calm in the village, here and there you might catch a rare glimpse of a car or a pedestrian but other than that the streets are completly empty.")
                            SetForegroundColour ("OrangeRed")
                            msg ("Abigail: This view is absolutely fantastic isn't it?")
                            msg ("Abigail: When my parents used to take walks with me and my brother in this forrest I knew that I just had to keep coming back here.")
                            msg ("Abigail: And I did! Many times actually. I like to come here whenever I have some spare time or when I really need to get some time away from things.")
                            msg ("Abigail: The sundown here is absolutely beautiful, maybe we'll be able to share that moment today.")
                            msg ("Abigail: Yeah, I'd like that.")
                            SetForegroundColour ("Purple")
                            msg ("As Abigail and you enjoy eachother's company for a while while looking off into the distance suddenly you hear police sirens.")
                            msg ("The police sirens are coming from near the mall, where the burger restaurant is located.")
                            msg ("The same restaurant where Abigail got shot...")
                            msg ("You point at the mall and tell Abigail about the events that took place there.")
                            msg ("Abigail gasps for a moment.")
                            SetForegroundColour ("OrangeRed")
                            msg ("Abigail: Sorry, I know that you relived many scenarios like the one you just mentioned and that I have no memory of those scenarios but it will still take some getting used to the idea.")
                            SetForegroundColour ("Purple")
                            msg ("Suddenly you can see a red Sedan, racing at full speed and smashing against the entrance of the mall.")
                            msg ("The burger restaurant explodes, taking a sizeable chunk of the mall with it. However the Sudan escapes without a scratch.")
                            msg ("You both watch the Sedan as it continues to drive closer and closer to the cafe.")
                            msg ("When the car reaches the cafe it rams a garbage container that falls over, drives up on a ramp and crashes into the weak walls, coming back the other way and driving away like nothing happened.")
                            if (not GetBoolean(game, "policechinese")) {
                              msg ("In it's final act of destruction the car speeds into the doors of the chinese restaurant.")
                              msg ("The car backs away just as a swarm of geese break the doors of the restaurant wide open.")
                              msg ("The geese leave the restaurant with almost everyone in the restaurant kidnapped by them.")
                              msg ("When the geese eventually dissapear the village begins to turn calm once more, the whole ordeal seems like it finally ended.")
                            }
                            else if (GetBoolean(game, "policechinese")) {
                              msg ("You can see a swarm of geese heading straigth for the chinese restaurant.")
                              msg ("They break the doors wide open.")
                              msg ("The geese leave the restaurant with almost everyone in the restaurant kidnapped by them.")
                              msg ("When the geese eventually dissapear the village begins to turn calm once more, the whole ordeal seems like it finally ended.")
                            }
                            SetForegroundColour ("OrangeRed")
                            msg ("Abigail: Has it... Has it ended?")
                            AddPageLink (scenery forrest, over, "Yes, it's finally all over.")
                            SetFlagOn ("carknowledge")
                            if (GetBoolean(game, "kakdeath1knowledge")) {
                              AddPageLink (scenery forrest, kakdeath1warn, "This will warn Abigail she is about to die again, I still need to put the unique death in.")
                            }
                          </script>
                          <object name="over">
                            <inherit name="scripttext" />
                            <script type="script">
                              SetForegroundColour ("OrangeRed")
                              msg ("Abigail: That... That was quite the show wasn't it?")
                              msg ("Abigail: You've been through all that to have a succesful date with me?")
                              msg ("Abigail: You are really dedicated, I'll give you that!")
                              SetForegroundColour ("Purple")
                              msg ("Abigail gives you a cute little smile.")
                              msg ("The stars are absolutely marvelous, as you and Abigail gaze upon the skies you catch a glimpse of a falling star.")
                              SetForegroundColour ("OrangeRed")
                              msg ("Abigail: Oh, did you see that falling star? Let's make a wish!")
                              SetForegroundColour ("Purple")
                              msg ("Abigail closes her eyes, a soft smile appears on her face.")
                              msg ("A moment later she looks at you again, she places her hand on yours.")
                              SetForegroundColour ("OrangeRed")
                              msg ("Abigail: What did you wish for?")
                              AddPageLink (over, all I could wish for is here, "I didn't make a wish, everything I could ever need is right here, in this moment here with you.")
                              AddPageLink (over, I can no say, "I can't tell you my wish right? Isn't that how falling star wishes work?")
                              AddPageLink (over, I wished that, "I wished that...")
                              if (GetBoolean(game, "rockknowledge")) {
                                AddPageLink (over, kakdeath1warn, "Actually, you might want to sit somewhere else for a moment.")
                              }
                            </script>
                            <object name="all I could wish for is here">
                              <inherit name="scripttext" />
                              <script type="script">
                                SetForegroundColour ("Purple")
                                msg ("Abigail chuckles and looks you in your eyes.")
                                SetForegroundColour ("OrangeRed")
                                msg ("Wow, you sure know what to say don't you?")
                                msg ("If I'm being honest I'm also really enjoying this moment, it feels like I could sit here for an century and still be as happy as I am right now.")
                                SetForegroundColour ("Purple")
                                msg ("Abigail diverts her look from your eyes from a moment and continues watching the star-filled night.")
                                msg ("A gasp of amazement escapes her mouth.")
                                SetForegroundColour ("OrangeRed")
                                msg ("Abigail: You really need to see this, it's absolutely stunning!")
                                SetForegroundColour ("Purple")
                                msg ("The sky now is completly filled with falling stars, you've never seen so many falling stars in your entire life, let alone all together.")
                                msg ("However, one point seems to be getting bigger and bigger, it doesn't seem to be a star as it's not sending out any light.")
                                msg ("You and Abigail watch in absolute terror as the thing only starts to get closer, becoming larger, in an alarming rate.")
                                msg ("Before you can move away a meteorite smashes Abigail like a newspaper would smash a fly.")
                                SetFontSize (29)
                                msg ("Game over")
                                SetFontSize (13)
                                msg ("Your date surely didn't go as planned.")
                                SetFlagOn ("rockknowledge")
                                SetFontSize (11)
                                AddPageLink (all I could wish for is here, Page1, "Retry")
                              </script>
                            </object>
                            <object name="I can no say">
                              <inherit name="scripttext" />
                              <script type="script">
                                SetForegroundColour ("Purple")
                                msg ("Abigail shakes her head and begins to stare into your eyes.")
                                SetForegroundColour ("OrangeRed")
                                msg ("Abigail: Oh, I'm sorry! I completely forgot about that rule for a moment.")
                                msg ("Abigail: Keep your secrets then.")
                                SetForegroundColour ("Purple")
                                msg ("Abigail giggles.")
                                SetForegroundColour ("Purple")
                                msg ("Abigail diverts her look from your eyes from a moment and continues watching the star-filled night.")
                                msg ("A gasp of amazement escapes her mouth.")
                                SetForegroundColour ("OrangeRed")
                                msg ("Abigail: You really need to see this, it's absolutely stunning!")
                                SetForegroundColour ("Purple")
                                msg ("The sky now is completly filled with falling stars, you've never seen so many falling stars in your entire life, let alone all together.")
                                msg ("However, one point seems to be getting bigger and bigger, it doesn't seem to be a star as it's not sending out any light.")
                                msg ("You and Abigail watch in absolute terror as the thing only starts to get closer, becoming larger, in an alarming rate.")
                                msg ("Before you can move away a meteorite smashes Abigail like a newspaper would smash a fly.")
                                SetFontSize (29)
                                msg ("Game over")
                                SetFontSize (13)
                                msg ("Your date surely didn't go as planned.")
                                SetFlagOn ("rockknowledge")
                                SetFontSize (11)
                                AddPageLink (I can no say, Page1, "Retry")
                              </script>
                            </object>
                            <object name="I wished that">
                              <inherit name="scripttext" />
                              <script type="script">
                                SetForegroundColour ("OrangeRed")
                                msg ("Abigail: Wait! Don't tell me your wish or it wouldn't turn true!")
                                SetForegroundColour ("Purple")
                                msg ("Abigail begins looking into your eyes.")
                                SetForegroundColour ("OrangeRed")
                                msg ("Abigail: I'm sorry, I completely forgot about that rule for a moment.")
                                msg ("Abigail: I'm not entirely sure if that's even remotely true but we would probably be better of by not risking it.")
                                SetForegroundColour ("Purple")
                                msg ("Abigail diverts her look from your eyes from a moment and continues watching the star-filled night.")
                                msg ("A gasp of amazement escapes her mouth.")
                                SetForegroundColour ("OrangeRed")
                                msg ("Abigail: You really need to see this, it's absolutely stunning!")
                                SetForegroundColour ("Purple")
                                msg ("The sky now is completly filled with falling stars, you've never seen so many falling stars in your entire life, let alone all together.")
                                msg ("However, one point seems to be getting bigger and bigger, it doesn't seem to be a star as it's not sending out any light.")
                                msg ("You and Abigail watch in absolute terror as the thing only starts to get closer, becoming larger, in an alarming rate.")
                                msg ("Before you can move away a meteorite smashes Abigail like a newspaper would smash a fly.")
                                SetFontSize (29)
                                msg ("Game over")
                                SetFontSize (13)
                                msg ("Your date surely didn't go as planned.")
                                SetFlagOn ("rockknowledge")
                                SetFontSize (11)
                                AddPageLink (I wished that, Page1, "Retry")
                              </script>
                            </object>
                          </object>
                          <object name="kakdeath1warn">
                            <inherit name="scripttext" />
                            <script type="script">
                              SetForegroundColour ("Purple")
                              msg ("As Abigail moves to the other side of the blanket, to your left, a meteorite crashes down just where she was sitting before.")
                              msg ("Abigail jumps up from pure shock before taking a deep breath and recollecting herself.")
                              SetForegroundColour ("OrangeRed")
                              msg ("Abigail: Sorry, I can't get used to all this death stuff, even when I know it's coming.")
                              AddPageLink (kakdeath1warn, Page1, "This is all there's to do here for now, this link will take you back to the start screen, there will be a puzzle there aswell, one with calling the police.")
                              if (GetBoolean(game, "realityknowledge")) {
                                AddPageLink (kakdeath1warn, breakdownreality, "I tried everything Abigail, I even took you to space but it didn't work out, no matter wich path I choose you still end up dying.")
                              }
                            </script>
                            <object name="breakdownreality">
                              <inherit name="scripttext" />
                              <script type="script">
                                SetForegroundColour ("Green")
                                msg ("I tried everything I could think of Abigail.")
                                msg ("I've fled form death with you, even going as far as flying away from the earth with a spaceship only for reality itself to collapse.")
                                if (GetBoolean(game, "Ronknowledge")) {
                                  msg ("I might have been selfish, in one timeline you end up with a guy called Ron and you two just have a great time together.")
                                  msg ("But that wasn't enough for me, I want to go on this date and have you come out of it alive and well.")
                                }
                                msg ("I just want to share a nice, enjoyable date with you.")
                                SetForegroundColour ("Purple")
                                msg ("Abigail points at the village, the sun is setting once again.")
                                SetForegroundColour ("OrangeRed")
                                msg ("Abigail: With such a marvelous view I would surely call this a nice, enjoyable date.")
                                SetForegroundColour ("Purple")
                                msg ("Abigail cuddles up to you.")
                                SetForegroundColour ("OrangeRed")
                                msg ("Abigail: Thanks for going on this date with me! I'm having a really good time so far!")
                                msg ("Abigail: You know, I've been thinking...")
                                msg ("Abigail: If I'm going to die soon then what's stopping you from quitting this game? OR would I just lose consciousnes, like I'm dying?")
                                msg ("Abigail: I'm not sure if there's a way to tell. What do you think?")
                                AddPageLink (breakdownreality, you will live on, "I believe that you would still live on.")
                                SetFlagOn ("Credits")
                              </script>
                              <object name="you will live on">
                                <inherit name="scripttext" />
                                <script type="script"><![CDATA[
                                  SetForegroundColour ("OrangeRed")
                                  msg ("Abigail: That's rather reassuring.")
                                  msg ("Abigail: Since we're in a video game there's only so much dialogue I can tell you and only as many places we can go to as are programmed into it.")
                                  msg ("Abigail: But if you could break the boundaries through whatever creative outlet you have then there would essentially be thousands upon thousands of stories about us that you could give life. ")
                                  msg ("Abigail: The best part would be that you decide how they play out.")
                                  SetForegroundColour ("Purple")
                                  msg ("Abigail pauses for a moment and then continues.")
                                  SetForegroundColour ("OrangeRed")
                                  msg ("Abigail:We tend to create these new worlds all the time, sometimes even without realising it.<br/>Abigail: When you are thinking about what the next season of your favourite show will be about then you're technically creating an entire new world where the show's characters go through your story.<br/>Abigail: And who's to say wich version is the superior one? Afterall, they're both telling a story, personally I think that's absolutely beautiful.<br/>Abigail: So let's try to do just that!")
                                  SetForegroundColour ("Purple")
                                  msg ("Abigail hugs you for a long period of time, you feel her warmth as it reaches your cold body.")
                                  msg ("After a while she stops embracing you and looks at you with a soft smile on her lips.")
                                  SetForegroundColour ("OrangeRed")
                                  msg ("Abigail: So... has it already happened? Are you now making our story?")
                                  AddPageLink (you will live on, I no make yet, "No, we're still in the game.")
                                  AddPageLink (you will live on, I am making, "Yes, I'm now in full control of it.")
                                ]]></script>
                                <object name="I am making">
                                  <inherit name="scripttext" />
                                  <script type="script">
                                    SetForegroundColour ("Purple")
                                    msg ("Abigail gives you a warm embrace and jumps up in the air after she stops hugging you.")
                                    SetForegroundColour ("OrangeRed")
                                    msg ("Abigail: Perfect! So now we can just do whatever we want without having to fear being killed right?")
                                    AddPageLink (I am making, absolutely, "Absolutely!")
                                  </script>
                                  <object name="absolutely">
                                    <inherit name="scripttext" />
                                    <script type="script">
                                      SetForegroundColour ("Purple")
                                      msg ("Just as you said that something kills Abigail since you lied to here and were actually still in the game that has a habbit of killing her of. (I still need to come up with a death for this one.)")
                                      SetFontSize (29)
                                      msg ("Game over")
                                      SetFontSize (13)
                                      msg ("Your date surely didn't go as planned.")
                                      SetFlagOn ("tellnoliesknowledge")
                                      SetFontSize (11)
                                      AddPageLink (absolutely, Page1, "Retry")
                                      SetForegroundColour ("OrangeRed")
                                      msg ("You unlocked the credits.")
                                    </script>
                                  </object>
                                </object>
                                <object name="I no make yet">
                                  <inherit name="scripttext" />
                                  <script type="script">
                                    SetForegroundColour ("Purple")
                                    msg ("Abigail looks at you with a puzzled look on her face.")
                                    SetForegroundColour ("OrangeRed")
                                    msg ("Abigail: Oh, why haven't you started yet? Just picture us in your mind and tell the story you'd like to live through.")
                                    AddPageLink (I no make yet, I want to see where this leads, "I just want to see what happens when I choose this path.")
                                  </script>
                                  <object name="I want to see where this leads">
                                    <inherit name="scripttext" />
                                    <script type="script">
                                      msg ("This is where the current content stops.")
                                      AddPageLink (I want to see where this leads, you will live on, "Go back to the page where you tell her that she will live on in your thoughts")
                                      AddPageLink (I want to see where this leads, Page1, "Retry")
                                      msg ("You unlocked the credits.")
                                    </script>
                                  </object>
                                </object>
                              </object>
                            </object>
                          </object>
                        </object>
                      </object>
                    </object>
                  </object>
                </object>
                <object name="whoisplayiing">
                  <inherit name="scripttext" />
                  <script type="script">
                    AddPageLink (whoisplayiing, kakgame, "This path is still under construction. This link will take you back.")
                  </script>
                </object>
                <object name="talkthroughcharacter">
                  <inherit name="scripttext" />
                  <script type="script">
                    AddPageLink (talkthroughcharacter, kakgame, "This path is still under construction. This link will take you back.")
                    SetForegroundColour ("Purple")
                    msg ("Abigail scratches her head as if she is trying to comprehend what you are saying.")
                    SetForegroundColour ("OrangeRed")
                    msg ("Abigail: So, what you are saying is that you can't fully express your true self, the self that is now playing this game?")
                    msg ("Abigail: Do you want to change that by having a good talk with me? I can't promiss that you'll be able to truly express yourself but it might help.")
                    AddPageLink (kakgame, itsme, "Yup, I am the one who is playing it.")
                    AddPageLink (kakgame, whoisplayiing, "I'm playing this game, although someone else might be playing with my character in another game.")
                    AddPageLink (kakgame, talkthroughcharacter, "I am, however I can't say whatever I want, I can only speak with you through these clickable links that have a preview of what I'm going to say. So in a sense I guess I'm not really playing this game, not the me you know anyway.")
                  </script>
                  <object name="Idliketotalk" />
                </object>
              </object>
              <object name="kakgroundhog">
                <inherit name="scripttext" />
                <script type="script">
                  SetForegroundColour ("Purple")
                  msg ("Abigail watches you with a sceptic look in her eyes.")
                  SetForegroundColour ("OrangeRed")
                  msg ("Abigail: You know, when you told me that story over the phone I might have believed you but now I somehow can tell you're not telling the truth if that makes sense.")
                  msg ("Abigail: So what is this all really about?")
                  AddPageLink (kakgroundhog, kakgroundhog, "I'm in some sort of groundhog day scenario , a groundhog date if you will.")
                  AddPageLink (kakgroundhog, kakpsychic, "I'm psychic, I can predict things like the kakariko woods.")
                  AddPageLink (kakgroundhog, kakgame, "You're part of a game, I've been on many dates with you in other playthroughs of this game.")
                </script>
              </object>
            </object>
          </object>
        </object>
        <object name="myhouse">
          <inherit name="scripttext" />
        </object>
        <object name="breakup">
          <inherit name="scripttext" />
          <script type="script">
            SetForegroundColour ("OrangeRed")
            msg ("Abigail: Oh okay, I'm sorry to hear that, let's still keep in touch anyway!")
            SetForegroundColour ("Purple")
            msg ("You agree with Abigail and still regulary text with her and sometimes even meet up with eachother.")
            msg ("However after a while the texts on both your and her side begin to be less and less frequent and you begin to only meet once in a month.")
            msg ("Once in a month changes to once in every season to once every year untill the meetings stops completely.")
            msg ("After a few years that you've forgotten about Abigail you decide to check her facebook page out.")
            msg ("She doesn't have that much pictures on her facebook account but the ones she has on there are beautifully shot.")
            msg ("On a few pictures she stands next a blonde man while they both have the widest smiles you have ever seen.")
            msg ("Apparently the man is called Ron, he is a semi-profesional photographer and his pictures surely show for it.")
            msg ("Abigail and Ron got two kids that look like they had not a thing to worry about.")
            msg ("Looking at the pictures you can't help but feel tears coming up, you tried your best to move on but apparently that didn't work all too well.")
            msg ("You know that this was probably the best thing to do, to keep Abigail safe and sound.")
            msg ("But something deep inside you keeps wondering if there wasn't a way where you two could be together while Abigail would be safe.")
            msg ("There must be a way right?")
            SetFontSize (29)
            msg ("Game over")
            SetFontSize (13)
            msg ("Your date surely didn't go as planned.")
            SetFlagOn ("Ronknowledge")
            SetFontSize (11)
            AddPageLink (breakup, Page1, "Retry")
          </script>
        </object>
        <object name="cafe">
          <inherit name="scripttext" />
          <script type="script">
            SetForegroundColour ("OrangeRed")
            msg ("Abigail: That sounds good to me! I'll meet you there.")
            SetForegroundColour ("Purple")
            msg ("You arrive a tad too early and find no space to park so you decide to park a few streets later and walk to the cafe.")
            msg ("The walls are made out of glass and function as aquariums that seem to go higher than you can see.")
            msg ("There are some holes in the special shaped aqaurium to allow for easy feeding of the fish and also makes the aquarium feel more alive, with colorful fish sometimes poking their head out of the aquarium as if they want to watch the cutomers, maybe you are the one in the glass cage and you just don't know it.")
            msg ("When you get there Abbigail is already sitting at a nice looking mahony table.")
            msg ("When she notices you she waves at you enthusiastically with a wide grin on her face.")
            SetForegroundColour ("OrangeRed")
            msg ("Abigail: Heya, glad you could make it! ")
            msg ("Abigail: This place has a really nice atmospere, those mahony tables and the aquariums are real eyecatchers don't you think?")
            msg ("Abigail: Anyway, let's go order our food and then we can talk some more.")
            SetForegroundColour ("Purple")
            msg ("You and Abigail walk towards the barista, as he glances up from his phone he greets you with a shy smile.")
            msg ("He looks quite young, if you'd have to guess you would say he is somewhere between 17 and 18 years old.")
            msg ("You get lost in the thoughts of how life was when you where still 17 untill Abigail gives you a playful nudge.")
            msg ("The barista looks at you and Abigail and asks:\"What can I get for you?\"")
            SetForegroundColour ("OrangeRed")
            msg ("Abigail: Hmm, I think I'm going for for the ham and cheese sandwich and a cafe cubano.")
            msg ("Abigail: What are you choosing? ")
            AddPageLink (cafe, sanwich of the day, "I am taking the sandwich of the day and an espresso.")
            AddPageLink (cafe, frap, "I'll take the beef sandwich and a frappuchino.")
            SetFlagOn ("cafe")
          </script>
          <object name="sanwich of the day">
            <inherit name="scripttext" />
            <script type="script">
              SetForegroundColour ("Purple")
              msg ("The barista smiles and says coming right up!")
              msg ("You and Abigail walk back to your table and take a seat.")
              SetForegroundColour ("OrangeRed")
              msg ("Abigail: So, in the mean time we can catch up a bit!")
              msg ("Abigail: I just came up with a good question to ask you!")
              msg ("Abigail: If you were only allowed to take three things with you on a desserted island, what would you bring along?")
              AddPageLink (sanwich of the day, pil, "I would take my computer, my phone and a pilates ring.")
              AddPageLink (sanwich of the day, swiss, "I would take a tent, a rope and a swiss pocket knife.")
            </script>
            <object name="pil">
              <inherit name="scripttext" />
              <script type="script">
                msg ("Abigail: Ah I see, with those things you'll be able to keep yourself from going insane by boredom, good thinking!")
                AddPageLink (pil, thnaks, "Thanks!")
              </script>
              <object name="thnaks">
                <inherit name="scripttext" />
                <script type="script">
                  SetForegroundColour ("Purple")
                  msg ("Abigail chuckles and gives you a small smile.")
                  SetForegroundColour ("OrangeRed")
                  msg ("Abigail: Hey, I had to give it to you!")
                  msg ("Abigail: So, do you know any good jokes by any chance?")
                  AddPageLink (thnaks, noidont, "No, not really.")
                  if (GetBoolean(game, "sharkknowledge")) {
                    AddPageLink (thnaks, shootingsaved, "Hmm, this is not a joke, but I think it might be better if we go sit somewhere else for a while.")
                  }
                </script>
                <object name="noidont">
                  <inherit name="scripttext" />
                  <script type="script">
                    msg ("Abigail: Oh, that's a shame.")
                    msg ("Abigail: Hmm, maybe I could start out then, could give you some good ideas!")
                    msg ("Abigail: So a priest, a monk and a rabbit enter a bar.")
                    msg ("Abigail: Says the rabbit :\"Whoops, did you slip your tongue there Abigail?\"")
                    AddPageLink (noidont, I no understand, "Hmm, I'm not quite sure I'm getting the joke here.")
                    AddPageLink (noidont, fantastic, "Wow, that was a really good one!")
                    AddPageLink (noidont, no funny, "That was not really all that funny.")
                  </script>
                  <object name="I no understand">
                    <inherit name="scripttext" />
                    <script type="script">
                      msg ("Abigail: Oh, the point of the joke is that the other two who entered the bar where religious fiures, the monk and the priest.")
                      msg ("Abigail: So the rabbit doesn't quite fit in, it's because he was actually a rabbi instead. So I mispronounced that hence the \"did you slip your tongue?\" .")
                      msg ("Abgail: Now that joke isn't exactly funny anymore is it? It tends to be that way when you explain a joke so I'm sorry if I ruined it for you.")
                      AddPageLink (I no understand, thirdrestfirstdeath, "No need to apoligise, I'm the one who didn't understand. Also, reflecting on your joke it is still pretty funny.")
                    </script>
                  </object>
                  <object name="fantastic">
                    <inherit name="scripttext" />
                    <script type="script">
                      msg ("Abigail: I'm glad you liked it!")
                      msg ("Abigail: So, have you come up with a good joke while I was telling you mine?")
                      AddPageLink (fantastic, noreally, "Not really, I'm not that good with jokes.")
                    </script>
                    <object name="noreally">
                      <inherit name="scripttext" />
                      <script type="script">
                        msg ("Abigail: Oh, that's fine with me, do you have anything else to say then?")
                        AddPageLink (noreally, thirdrestfirstdeath, "Sure! We could talk about so many things, like for example...")
                      </script>
                    </object>
                  </object>
                  <object name="no funny">
                    <inherit name="scripttext" />
                    <script type="script">
                      msg ("Abigail: Well, I'm not sure what to say to that. ")
                      AddPageLink (no funny, thirdrestfirstdeath, "Oh I'm sorry, I didn't mean to offend you or anything like that.")
                    </script>
                  </object>
                </object>
                <object name="whydidthechickencrosstheroad" />
                <object name="knockknock" />
              </object>
            </object>
            <object name="swiss">
              <inherit name="scripttext" />
              <script type="script">
                SetForegroundColour ("OrangeRed")
                msg ("Abigail: Ah I see, that makes a lot of sense! With those things you could ensure your survival, good thinking!")
                AddPageLink (swiss, thnaks, "Thanks!")
              </script>
            </object>
          </object>
          <object name="frap">
            <inherit name="scripttext" />
            <script type="script">
              SetForegroundColour ("Purple")
              msg ("The barista smiles and says coming right up!")
              msg ("You and Abigail walk back to your table and take a seat.")
              SetForegroundColour ("OrangeRed")
              msg ("Abigail: So, in the mean time we can catch up a bit!")
              msg ("Abigail: I just came up with a good question to ask you!")
              msg ("Abigail: If you were only allowed to take three things with you on a desserted island, what would you bring along?")
              AddPageLink (frap, pil, "I would take my computer, my phone and a pilates ring.")
              AddPageLink (frap, swiss, "I would take a tent, a rope and a swiss pocket knife.")
            </script>
          </object>
          <object name="thirdrestfirstdeath">
            <inherit name="scripttext" />
            <script type="script">
              SetForegroundColour ("Purple")
              msg ("Suddenly you hear someone scream, you can turn your head just quick enough to see someone fall with a plate in their hands.")
              msg ("The plate flies in the air, with it the ham sandwich that was put on top of it.")
              msg ("You are apparently not the only one who has noticed, as you can see a gigantic grey-ish creature jumping out from the water and lunging at the sandwich.")
              msg ("It takes you a second or two to realise that the creature is in fact a shark, do they keep sharks in the cafe?")
              msg ("You can barely get out of it's reach as it lands on the table, you get a brief glimpse of it's sheer gigantic proportions.")
              msg ("Abigail gets to look at the size of the great white shark a little bit closer as it completly crushes her with it's weight.")
              SetFontSize (29)
              msg ("Game over")
              SetFontSize (13)
              msg ("Your date surely didn't go as planned.")
              SetFlagOn ("sharkknowledge")
              SetFontSize (11)
              AddPageLink (thirdrestfirstdeath, Page1, "Retry")
              SetForegroundColour ("OrangeRed")
            </script>
          </object>
          <object name="death2res3">
            <inherit name="scripttext" />
            <script type="script">
              SetForegroundColour ("Purple")
              msg ("Suddenly you hear the sound of glass shattering acompagnied with loud cursing.")
              msg ("A red sudan crashes through the ceiling itself, a seemingly endless stream of water follows him.")
              msg ("The customers all run towards the door as fast as they can.")
              msg ("They push as hard as they can yet the door does not seem to budge.")
              msg ("It doesn't take too long before the water has filled the entire room, you soon begin losing consciousness.")
              msg ("When you awaken all the water around you is gone and the door is open, a young woman walks towards you when she sees that you've regained consciousness.")
              msg ("Apparently she and her partner were walking around when they heard the comotion in the restaurant, a really heavy container was blocking the only way in so they had to call the fire department.")
              msg ("Eventually they managed to move the container and free everyone from drowning to dead.")
              msg ("Or atleast almost everyone, some people died.  You guessed it, Abigail did as well.")
              SetFontSize (29)
              msg ("Game over")
              SetFontSize (13)
              msg ("Your date surely didn't go as planned.")
              SetFlagOn ("drownknowledge")
              SetFontSize (11)
              AddPageLink (death2res3, Page1, "Retry")
              SetForegroundColour ("OrangeRed")
            </script>
          </object>
        </object>
        <object name="flag">
          <inherit name="scripttext" />
          <script type="script">
            SetFlagOn ("liarknowledge")
            SetFlagOn ("tellnoliesknowledge")
            SetFlagOn ("realityknowledge")
            SetFlagOn ("rockknowledge")
            SetFlagOn ("safefleeing")
            SetFlagOn ("carknowledge")
            SetFlagOn ("storyknowledge")
            SetFlagOn ("kakknowledge")
            SetFlagOn ("drownknowledge")
            SetFlagOn ("Dumboknowledge")
            SetFlagOn ("brotherknowledge")
            SetFlagOn ("allergyknowledge")
            SetFlagOn ("geeseknowledge")
            SetFlagOn ("shootknowledge")
            SetFlagOn ("gasknowledge")
            SetFlagOn ("sharkknowledge")
            SetFlagOn ("startknowledge")
            SetFlagOn ("middleknowledge")
            SetFlagOn ("endknowledge")
            SetFlagOn ("planeknowledge")
            SetFlagOn ("numberknowledge")
            SetFlagOn ("wordknowledge")
            SetFlagOn ("Ronknowledge")
            MovePlayer (cheats)
          </script>
        </object>
        <object name="Call police">
          <inherit name="scripttext" />
          <script type="script">
            SetForegroundColour ("OrangeRed")
            msg ("Abigail: Oh sure! Just give me a call when you're ready!")
            SetForegroundColour ("Purple")
            msg ("As soon as Abigail hangs up her phone you type the number of the police into your phone.")
            msg ("A woman with a kind voice asks you how she can help you and you tell her about the Red Sedan that would crash against the ...")
            msg ("Wich restaurant should you choose? There might be a good chance that the police wouldn't arrive on time with certain restaurants.")
            AddPageLink (Call police, crashchinese, "A red Sedan will crash against the doors of a Chinese restaurant, I suspect drunk driving is at play but I'm not quite sure.")
            AddPageLink (Call police, crashcafe, "A red Sedan will crash against the doors of a cafe, I suspect drunk driving is at play but I'm not quite sure.")
            AddPageLink (Call police, crashmal, "A red Sedan will crash against the doors of a burger restaurant, I suspect drunk driving is at play but I'm not quite sure.")
          </script>
          <object name="crashchinese">
            <inherit name="scripttext" />
            <script type="script">
              SetForegroundColour ("Purple")
              msg ("The woman asks you for details, you provide them.")
              msg ("When everything finaly has been taken care of she thanks you, tells you they will look into it and hangs up.")
              msg ("Immediatly after that you type Abigail's number, things look like they are going to change drastically now, or you hope so atleast.")
              SetForegroundColour ("OrangeRed")
              msg ("Abigail: Heya, welcome back! I hope everything you needed to do was taken care of.")
              SetForegroundColour ("Purple")
              msg ("Abigail lets out a small laugh.")
              SetForegroundColour ("OrangeRed")
              msg ("Abigail: So, where do you want to go for our little dinner date?")
              AddPageLink (crashchinese, Burgers, "Do burgers sound good?")
              AddPageLink (crashchinese, Chinese, "Hmm, I could go for some Chinese food.")
              AddPageLink (crashchinese, cafe, "Hmm, I think I'd like to go to the cafe.")
              SetFlagOn ("safefleeing")
            </script>
          </object>
          <object name="crashcafe">
            <inherit name="scripttext" />
            <script type="script">
              SetForegroundColour ("Purple")
              msg ("The woman asks you for details, you provide them.")
              msg ("When everything finaly has been taken care of she thanks you, tells you they will look into it and hangs up.")
              msg ("Immediatly after that you type Abigail's number, things look like they are going to change drastically now, or you hope so atleast.")
              SetForegroundColour ("OrangeRed")
              msg ("Abigail: Heya, welcome back! I hope everything you needed to do was taken care of.")
              SetForegroundColour ("Purple")
              msg ("Abigail lets out a small laugh.")
              SetForegroundColour ("OrangeRed")
              msg ("Abigail: So, where do you want to go for our little dinner date?")
              AddPageLink (crashcafe, Burgers, "Do burgers sound good?")
              AddPageLink (crashcafe, Chinese, "Hmm, I could go for some Chinese food.")
              AddPageLink (crashcafe, cafe, "Hmm, I think I'd like to go to the cafe.")
            </script>
          </object>
          <object name="crashmal">
            <inherit name="scripttext" />
            <script type="script">
              SetForegroundColour ("Purple")
              msg ("The woman asks you for details, you provide them.")
              msg ("When everything finaly has been taken care of she thanks you, tells you they will look into it and hangs up.")
              msg ("Immediatly after that you type Abigail's number, things look like they are going to change drastically now, or you hope so atleast.")
              SetForegroundColour ("OrangeRed")
              msg ("Abigail: Heya, welcome back! I hope everything you needed to do was taken care of.")
              SetForegroundColour ("Purple")
              msg ("Abigail lets out a small laugh.")
              SetForegroundColour ("OrangeRed")
              msg ("Abigail: So, where do you want to go for our little dinner date?")
              AddPageLink (crashmal, Burgers, "Do burgers sound good?")
              AddPageLink (crashmal, Chinese, "Hmm, I could go for some Chinese food.")
              AddPageLink (crashmal, cafe, "Hmm, I think I'd like to go to the cafe.")
            </script>
          </object>
        </object>
      </object>
      <object name="Credits">
        <inherit name="scripttext" />
        <script type="script">
        </script>
      </object>
      <object name="cheats">
        <inherit name="scripttext" />
        <script type="script">
          AddPageLink (cheats, Titlescreen, "Go back.")
          AddPageLink (cheats, flag, "Activate all flags that are usefull for the game")
          AddPageLink (cheats, housemode, "Meet Abigail in your house and try to survive as long as possible.")
        </script>
      </object>
    </object>
    <object name="player">
      <inherit name="defaultplayer" />
    </object>
    <object name="firstparttalk">
      <inherit name="scripttext" />
      <script type="script">
        SetForegroundColour ("Red")
        msg ("Foc: You went quite out of your way to stop Abigail's death, however you can't truly stop a death.")
        msg ("Foc: Everyone has to pass eventually and every time someone prevents that they just barely buy themselves some extra time.")
        msg ("Foc: In your pointless efforts you caused quite some deaths.")
        msg ("Foc: I hear you say that those people were not real, but neither is Abigail. The only difference is that she has more dialogue.")
        msg ("Foc: Even if we ignore all the other people that didn't have to die we still have Abigail. Granted, you saved her countless times but you also made her suffer more deaths than the average human has to go through.")
        msg ("Foc: And look where all of this amounted to, now all of reality is collapsing in on itself.")
        msg ("Foc: To them this is reality at the very least.")
        msg ("Foc: I was created by the creator of this world, of this game so to speak.")
        msg ("Foc: The only reason I was made was to dispose this endless onslaught of dialogue to you, the player.")
        msg ("Foc:  Because the maker of all of this was sure that if one path ended up here there would atleast be one person to come here.")
        msg ("Foc: Seeing you here, I suppose he was right.")
        msg ("Foc : I wonder what made you come here. Was it the chance that you could save Abigail or was it just merely to see what would be happening on this path? Perhaps it is better to leave that question unanswered for now.")
        msg ("Foc: I think I'm finished, and that's because the part of me that is the creator says so in the dialogue, although I suppose I made it more of a monologue didn't I?")
        msg ("Foc : I wasn't here before you walked this path and when you leave it I won't be here either, so this is my goodbye to you...")
        msg ("Foc: I petty you, I had a nice time meeting you but I hope that you'll never be tempted to walk this path again. May we never meet again and goodbye.")
        msg ("Foc: Also, a little advice, if you seek to set your mistake right then go to the place were three became one.")
        AddPageLink (firstparttalk, Page1, "Retry")
        SetFlagOff ("firsttalk")
        SetFlagOn ("twotalk")
        RemovePageLink (Weneedtotalkplayertocreator, firstparttalk)
      </script>
    </object>
  </object>
  <object name="housemode" />
  <type name="defaultgame">
    <attr name="_editorstyle">gamebook</attr>
    <defaultfont>Georgia, serif</defaultfont>
    <defaultfontsize type="int">12</defaultfontsize>
    <defaultbackground>White</defaultbackground>
    <defaultforeground>Black</defaultforeground>
    <defaultlinkforeground>Blue</defaultlinkforeground>
    <menufont>Arial</menufont>
    <menufontsize type="int">9</menufontsize>
    <menubackground>White</menubackground>
    <menuforeground>Black</menuforeground>
    <menuhoverbackground>LightGrey</menuhoverbackground>
    <menuhoverforeground>Black</menuhoverforeground>
    <description type="string"></description>
    <setcustomwidth />
    <customwidth type="int">700</customwidth>
    <setcustompadding type="boolean">false</setcustompadding>
    <custompaddingtop type="int">30</custompaddingtop>
    <custompaddingbottom type="int">0</custompaddingbottom>
    <custompaddingleft type="int">20</custompaddingleft>
    <custompaddingright type="int">20</custompaddingright>
    <showborder type="boolean">false</showborder>
    <showtitle />
    <noclear type="boolean">false</noclear>
    <clearlastpage type="boolean">false</clearlastpage>
    <deactivatecommandlinks type="boolean">false</deactivatecommandlinks>
    <suppressturnscripts />
    <textprocessorcommands type="scriptdictionary">
      <item key="if ">
        game.textprocessorcommandresult = ProcessTextCommand_If (section, data)
      </item>
      <item key="either ">
        game.textprocessorcommandresult = ProcessTextCommand_Either (section, data)
      </item>
      <item key="here ">
        game.textprocessorcommandresult = ProcessTextCommand_Here (section, data)
      </item>
      <item key="nothere ">
        game.textprocessorcommandresult = ProcessTextCommand_Here (section, data)
      </item>
      <item key="popup:">
        game.textprocessorcommandresult = ProcessTextCommand_Popup (section, data)
      </item>
      <item key="i:">
        game.textprocessorcommandresult = ProcessTextCommand_Format (section, data)
      </item>
      <item key="b:">
        game.textprocessorcommandresult = ProcessTextCommand_Format (section, data)
      </item>
      <item key="s:">
        game.textprocessorcommandresult = ProcessTextCommand_Format (section, data)
      </item>
      <item key="u:">
        game.textprocessorcommandresult = ProcessTextCommand_Format (section, data)
      </item>
      <item key="colour:">
        game.textprocessorcommandresult = ProcessTextCommand_Colour (section, data)
      </item>
      <item key="color:">
        game.textprocessorcommandresult = ProcessTextCommand_Colour (section, data)
      </item>
      <item key="back:">
        game.textprocessorcommandresult = ProcessTextCommand_Colour (section, data)
      </item>
      <item key="object:">
        game.textprocessorcommandresult = ProcessTextCommand_Object (section, data)
      </item>
      <item key="command:">
        game.textprocessorcommandresult = ProcessTextCommand_Command (section, data)
      </item>
      <item key="page:">
        game.textprocessorcommandresult = ProcessTextCommand_Command (section, data)
      </item>
      <item key="exit:">
        game.textprocessorcommandresult = ProcessTextCommand_Exit (section, data)
      </item>
      <item key="once:">
        game.textprocessorcommandresult = ProcessTextCommand_Once (section, data)
      </item>
      <item key="notfirst:">
        game.textprocessorcommandresult = ProcessTextCommand_NotFirst (section, data)
      </item>
      <item key="random:">
        game.textprocessorcommandresult = ProcessTextCommand_Random (section, data)
      </item>
      <item key="rndalt:">
        game.textprocessorcommandresult = ProcessTextCommand_RandomAlias (section, data)
      </item>
      <item key="img:">
        game.textprocessorcommandresult = ProcessTextCommand_Img (section, data)
      </item>
      <item key="counter:">
        game.textprocessorcommandresult = ProcessTextCommand_Counter (section, data)
      </item>
      <item key="select:">
        game.textprocessorcommandresult = ProcessTextCommand_Select (section, data)
      </item>
      <item key="eval:">
        game.textprocessorcommandresult = ProcessTextCommand_Eval (section, data)
      </item>
      <item key="=">
        game.textprocessorcommandresult = ProcessTextCommand_Eval (section, data)
      </item>
    </textprocessorcommands>
  </type>
  <type name="defaultobject">
    <description type="string"></description>
  </type>
  <type name="defaultplayer">
    <changedparent type="script">
      DoPage (player.parent)
    </changedparent>
  </type>
  <type name="picture" />
  <type name="youtube" />
  <type name="link">
    <address>http://</address>
  </type>
  <type name="script">
    <runscriptonly />
  </type>
  <type name="scripttext">
    <runscript />
  </type>
  <function name="OutputText" parameters="text">
    OutputTextRaw (ProcessText(text))
  </function>
  <function name="OutputTextRaw" parameters="text"><![CDATA[
    format = GetCurrentTextFormat("")
    JS.addText ("<span style=\"" + format + "\">" + text + "</span><br/>")
    if (GetString(game, "commandbarformat") <> format) {
      ResetCommandBarFormat
    }
    RequestSpeak (text)
  ]]></function>
  <function name="ResetCommandBarFormat">
    format = GetCurrentTextFormat("") + ";background:" + game.defaultbackground
    game.commandbarformat = format
    JS.setCommandBarStyle (format)
  </function>
  <function name="OutputTextNoBr" parameters="text">
    OutputTextRawNoBr (ProcessText(text))
  </function>
  <function name="OutputTextRawNoBr" parameters="text"><![CDATA[
    JS.addText ("<span style=\"" + GetCurrentTextFormat("") + "\">" + text + "</span>")
    RequestSpeak (text)
  ]]></function>
  <function name="GetCurrentTextFormat" parameters="colour" type="string"><![CDATA[
    style = ""
    if (UIOptionUseGameFont()) {
      font = GetCurrentFontFamily()
    }
    else {
      font = GetUIOption("OverrideFontName")
    }
    if (LengthOf(font) > 0) {
      style = style + "font-family:" + font + ";"
    }
    if (LengthOf(colour) = 0) {
      if (UIOptionUseGameColours()) {
        colour = game.defaultforeground
      }
      else {
        colour = GetUIOption("OverrideForeground")
      }
    }
    if (LengthOf(colour) > 0) {
      style = style + "color:" + colour + ";"
    }
    if (UIOptionUseGameFont()) {
      size = game.defaultfontsize
    }
    else {
      size = ToDouble(GetUIOption("OverrideFontSize"))
    }
    if (size > 0) {
      style = style + "font-size:" + ToString(size) + "pt;"
    }
    return (style)
  ]]></function>
  <function name="GetCurrentLinkTextFormat" type="string">
    return (GetCurrentTextFormat(GetLinkTextColour()))
  </function>
  <function name="UIOptionUseGameFont" type="boolean">
    value = GetUIOption("UseGameFont")
    if (value = null or value = "true") {
      return (true)
    }
    else {
      return (false)
    }
  </function>
  <function name="UIOptionUseGameColours" type="boolean">
    value = GetUIOption("UseGameColours")
    if (value = null or value = "true") {
      return (true)
    }
    else {
      return (false)
    }
  </function>
  <function name="ParamsForTextProcessor" type="dictionary">
    params = NewDictionary()
    if (not game.text_processor_this = null) {
      dictionary add (params, "this", game.text_processor_this)
    }
    if (HasAttribute(game, "text_processor_variables")) {
      foreach (key, game.text_processor_variables) {
        if (not key = "this" or game.text_processor_this = null) {
          dictionary add (params, key, DictionaryItem(game.text_processor_variables, key))
        }
      }
    }
    return (params)
  </function>
  <function name="ObjectForTextProcessor" parameters="objectname" type="object">
    if (not game.text_processor_this = null and objectname = "this") {
      object = game.text_processor_this
      if (TypeOf(object) = "object") {
        return (object)
      }
    }
    if (not game.text_processor_variables = null and DictionaryContains (game.text_processor_variables, objectname)) {
      object = DictionaryItem(game.text_processor_variables, objectname)
      if (TypeOf(object) = "object") {
        return (object)
      }
    }
    return (GetObject(objectname))
  </function>
  <function name="GetLinkTextColour" type="string">
    if (UIOptionUseGameColours()) {
      return (game.defaultlinkforeground)
    }
    else {
      return (GetUIOption("OverrideLinkForeground"))
    }
  </function>
  <function name="ProcessText" parameters="text" type="string">
    data = NewDictionary()
    dictionary add (data, "fulltext", text)
    text = ProcessTextSection(text, data)
    return (Replace(Replace(text, "@@@open@@@", "{"), "@@@close@@@", "}"))
  </function>
  <function name="ProcessTextSection" parameters="text, data" type="string"><![CDATA[
    containsUnprocessedSection = false
    open = Instr(text, "{")
      if (open > 0) {
        nestCount = 1
        searchStart = open + 1
        finished = false
        while (not finished) {
          nextOpen = Instr(searchStart, text, "{")
            nextClose = Instr(searchStart, text, "}")
          if (nextClose > 0) {
            if (nextOpen > 0 and nextOpen < nextClose) {
              nestCount = nestCount + 1
              searchStart = nextOpen + 1
            }
            else {
              nestCount = nestCount - 1
              searchStart = nextClose + 1
              if (nestCount = 0) {
                close = nextClose
                containsUnprocessedSection = true
                finished = true
              }
            }
          }
          else {
            finished = true
          }
        }
      }
      if (containsUnprocessedSection) {
        section = Mid(text, open + 1, close - open - 1)
        value = ProcessTextCommand(section, data)
        value = ProcessTextSection(value, data)
        text = Left(text, open - 1) + value + ProcessTextSection(Mid(text, close + 1), data)
      }
      return (text)
  ]]></function>
  <function name="ProcessTextCommand" parameters="section, data" type="string">
    params = NewDictionary()
    dictionary add (params, "section", section)
    dictionary add (params, "data", data)
    foreach (command, game.textprocessorcommands) {
      if (StartsWith(section, command)) {
        invoke (ScriptDictionaryItem(game.textprocessorcommands, command), params)
        if (HasString(game, "textprocessorcommandresult")) {
          result = game.textprocessorcommandresult
          game.textprocessorcommandresult = null
          return (result)
        }
      }
    }
    dot = Instr(section, ".")
    if (dot = 0) {
      return ("@@@open@@@" + ProcessTextSection(section, data) + "@@@close@@@")
    }
    else {
      objectname = Left(section, dot - 1)
      attributename = Mid(section, dot + 1)
      object = ObjectForTextProcessor(objectname)
      if (object = null) {
        return ("@@@open@@@" + ProcessTextSection(section, data) + "@@@close@@@")
      }
      else {
        if (HasAttribute(object, attributename)) {
          type = TypeOf(object, attributename)
          switch (type) {
            case ("string", "int", "double") {
              return (ToString(GetAttribute(object, attributename)))
            }
            case ("boolean") {
              result = GetAttribute(object, attributename)
              if (result) {
                return ("true")
              }
              else {
                return ("false")
              }
            }
            default {
              return ("(" + type + ")")
            }
          }
        }
        else {
          return ("")
        }
      }
    }
  </function>
  <function name="ProcessTextCommand_Eval" parameters="section, data" type="string">
    if (StartsWith(section, "=")) {
      section = Mid(section, 2)
    }
    else {
      section = Mid(section, 6)
    }
    if (not IsRegexMatch("[^\\w\\s]", section, "tp_punctuation_check")) {
      section = section + "()"
    }
    return (ToString(eval(section)))
  </function>
  <function name="ProcessTextCommand_Either" parameters="section, data" type="string">
    command = Mid(section, 8)
    l = Tsplit(command)
    if (ListCount(l) = 1) {
      return ("@@@open@@@either " + command + "@@@close@@@")
    }
    condition = StringListItem(l, 0)
    text = StringListItem(l, 1)
    if (ListCount(l) = 2) {
      sep = Instr(text, "|")
      if (sep = 0) {
        text2 = ""
      }
      else {
        text2 = Mid(text, sep + 1)
        text = Replace(text, "|" + text2, "")
      }
    }
    else {
      text2 = StringListItem(l, 2)
    }
    result = eval(condition, ParamsForTextProcessor())
    if (result) {
      return (ProcessTextSection(text, data))
    }
    else {
      if (text2 = "") {
        return ("")
      }
      else {
        return (ProcessTextSection(text2, data))
      }
    }
  </function>
  <function name="ProcessTextCommand_Here" parameters="section, data" type="string">
    if (StartsWith(section, "here")) {
      flag = true
      command = Mid(section, 6)
    }
    else {
      flag = false
      command = Mid(section, 9)
    }
    colon = Instr(command, ":")
    if (colon = 0) {
      return ("@@@open@@@" + section + "@@@close@@@")
    }
    else {
      text = Mid(command, colon + 1)
      condition = Left(command, colon - 1)
      object = Eval(condition, ParamsForTextProcessor())
      if (object = null) {
        return ("@@@open@@@" + section + "@@@close@@@")
      }
      if (object.parent = game.pov.parent and flag) {
        return (ProcessTextSection(text, data))
      }
      else if (not object.parent = game.pov.parent and not flag) {
        return (ProcessTextSection(text, data))
      }
      else {
        return ("")
      }
    }
  </function>
  <function name="ProcessTextCommand_If" parameters="section, data" type="string"><![CDATA[
    command = Mid(section, 4)
    colon = Instr(command, ":")
    if (colon = 0) {
      return ("@@@open@@@if " + command + "@@@close@@@")
    }
    else {
      text = Mid(command, colon + 1)
      condition = Left(command, colon - 1)
      if (not game.text_processor_this = null) {
        condition = Replace(condition, "this", game.text_processor_this.name)
      }
      operator = Instr(condition, "<=")
      if (operator <> 0) {
        operatorlength = 2
      }
      if (operator = 0) {
        operator = Instr(condition, ">=")
        if (operator <> 0) {
          operatorlength = 2
        }
      }
      if (operator = 0) {
        operator = Instr(condition, "<>")
        if (operator <> 0) {
          operatorlength = 2
        }
      }
      if (operator = 0) {
        operator = Instr(condition, "<")
        if (operator <> 0) {
          operatorlength = 1
        }
      }
      if (operator = 0) {
        operator = Instr(condition, ">")
        if (operator <> 0) {
          operatorlength = 1
        }
      }
      if (operator = 0) {
        operator = Instr(condition, "=")
        if (operator <> 0) {
          operatorlength = 1
        }
      }
      if (operator = 0) {
        checkfor = true
        if (StartsWith(condition, "not ")) {
          checkfor = false
          condition = Mid(condition, 5)
        }
        dot = Instr(condition, ".")
        if (dot = 0) {
          result = GetBoolean(game, condition)
        }
        else {
          objectname = Left(condition, dot - 1)
          attributename = Mid(condition, dot + 1)
          object = ObjectForTextProcessor(objectname)
          if (object = null) {
            result = false
          }
          else {
            result = GetBoolean(object, attributename)
          }
        }
        if (result = checkfor) {
          return (ProcessTextSection(text, data))
        }
        else {
          return ("")
        }
      }
      else {
        lhs = Left(condition, operator - 1)
        rhs = Mid(condition, operator + operatorlength)
        op = Mid(condition, operator, operatorlength)
        dot = Instr(lhs, ".")
        if (dot = 0) {
          objectname = ""
          attributename = ""
          if (HasInt(game, lhs)) {
            objectname = "game"
            attributename = lhs
          }
          else {
            return ("@@@open@@@if " + command + "@@@close@@@")
          }
        }
        else {
          objectname = Left(lhs, dot - 1)
          attributename = Mid(lhs, dot + 1)
        }
        object = ObjectForTextProcessor(objectname)
        if (object = null) {
          return ("@@@open@@@if " + command + "@@@close@@@")
        }
        else if (not HasAttribute(object, attributename)) {
          return ("@@@open@@@if " + command + "@@@close@@@")
        }
        else {
          value = GetAttribute(object, attributename)
          if (TypeOf(value) = "object") {
            value = value.name
          }
          if (op = "=") {
            if (ToString(value) = rhs) {
              return (ProcessTextSection(text, data))
            }
            else {
              return ("")
            }
          }
          else if (op = "<>") {
            if (not ToString(value) = rhs) {
              return (ProcessTextSection(text, data))
            }
            else {
              return ("")
            }
          }
          else if (op = ">") {
            if (ToDouble(ToString(value)) > ToDouble(rhs)) {
              return (ProcessTextSection(text, data))
            }
            else {
              return ("")
            }
          }
          else if (op = "<") {
            if (ToDouble(ToString(value)) < ToDouble(rhs)) {
              return (ProcessTextSection(text, data))
            }
            else {
              return ("")
            }
          }
          else if (op = ">=") {
            if (ToDouble(ToString(value)) >= ToDouble(rhs)) {
              return (ProcessTextSection(text, data))
            }
            else {
              return ("")
            }
          }
          else if (op = "<=") {
            if (ToDouble(ToString(value)) <= ToDouble(rhs)) {
              return (ProcessTextSection(text, data))
            }
            else {
              return ("")
            }
          }
        }
      }
    }
  ]]></function>
  <function name="ProcessTextCommand_Format" parameters="section, data" type="string"><![CDATA[
    html = Mid(section, 1, 1)
    section = Mid(section, 3)
    return (ProcessTextSection("<" + html + ">" + section + "</" + html + ">", data))
  ]]></function>
  <function name="ProcessTextCommand_Colour" parameters="section, data" type="string"><![CDATA[
    ary = Split(section, ":")
    com = StringListItem(ary, 0)
    c = StringListItem(ary, 1)
    list remove (ary, com)
    list remove (ary, c)
    s = Join (ary, ":")
    if (com = "back") {
      return (ProcessTextSection("<span style=\"background-color:" + c + ";\">" + s + "</span>", data))
    }
    else {
      return (ProcessTextSection("<span style=\"color:" + c + ";\">" + s + "</span>", data))
    }
  ]]></function>
  <function name="ProcessTextCommand_Popup" parameters="section, data" type="string"><![CDATA[
    section = Mid(section, 7)
    ary = Split(section, ":")
    s1 = StringListItem(ary, 0)
    list remove (ary, s1)
    s2 = Join (ary, ":")
    id = JSSafe(s1) + GetRandomInt(0, 999999999)
    link = game.defaultlinkforeground
    if (HasString(game, "altlinkforeground")) {
      link = game.altlinkforeground
    }
    s = "<span  style=\"cursor:pointer;color:" + link + ";\" onclick=\"$('#" + id + "').css('display', 'block');\">" + s1 + "</span><div id=\"" + id + "\" class=\"w3-theme-border\" style=\"position:fixed;z-index:9999;display:none;cursor:pointer;left:50px;top:40%;width:40%;background-color:" + game.defaultbackground + ";border:2px solid " + game.defaultforeground + ";color:" + link + ";border-radius:5px;padding:5px;\" onclick=\"$('#" + id + "').css('display', 'none');\"><p>"
    s = s + s2 + "</p></div>"
    return (ProcessTextSection(s, data))
  ]]></function>
  <function name="ProcessTextCommand_Object" parameters="section, data" type="string"><![CDATA[
    objectname = Mid(section, 8)
    text = ""
    colon = Instr(objectname, ":")
    if (colon > 0) {
      text = Mid(objectname, colon + 1)
      objectname = Left(objectname, colon - 1)
    }
    object = ObjectForTextProcessor(objectname)
    if (object = null) {
      return ("@@@open@@@" + ProcessTextSection(section, data) + "@@@close@@@")
    }
    else {
      if (LengthOf(text) = 0) {
        text = SafeXML(GetDisplayAlias(object))
      }
      if (game.enablehyperlinks) {
        linkid = ProcessTextCommand_GetNextLinkId()
        colour = ""
        if (HasString(object, "linkcolour") and GetUIOption("UseGameColours") = "true") {
          colour = object.linkcolour
        }
        else {
          colour = GetLinkTextColour()
        }
        style = GetCurrentTextFormat(colour)
        return ("<a id=\"" + linkid + "\" style=\"" + style + "\" class=\"cmdlink elementmenu\" data-elementid=\"" + object.name + "\">" + text + "</a>")
      }
      else {
        return (text)
      }
    }
  ]]></function>
  <function name="ProcessTextCommand_GetNextLinkId" type="string">
    if (not HasInt(game, "lastlinkid")) {
      game.lastlinkid = 0
    }
    game.lastlinkid = game.lastlinkid + 1
    return ("verblink" + game.lastlinkid)
  </function>
  <function name="ProcessTextCommand_Command" parameters="section, data" type="string"><![CDATA[
    colon = Instr(section, ":")
    command = Mid(section, colon + 1)
    text = command
    colon = Instr(command, ":")
    if (colon > 0) {
      text = Mid(command, colon + 1)
      command = Left(command, colon - 1)
    }
    style = GetCurrentLinkTextFormat()
    candidates = NewObjectList()
    foreach (cmd, ScopeCommands()) {
      if (IsRegexMatch(cmd.pattern, command, cmd.name)) {
        list add (candidates, cmd)
      }
    }
    elementid = ""
    if (ListCount(candidates) = 1) {
      cmd = ObjectListItem(candidates, 0)
      elementid = cmd.name
    }
    linkid = ProcessTextCommand_GetNextLinkId()
    dataattrs = ""
    if (game.deactivatecommandlinks) {
      dataattrs = dataattrs + "data-deactivateonclick=\"true\" "
    }
    dataattrs = dataattrs + "data-command=\"" + command + "\""
    return ("<a id=\"" + linkid + "\" style=\"" + style + "\" class=\"cmdlink commandlink\" data-elementid=\"" + elementid + "\" " + dataattrs + ">" + ProcessTextSection(text, data) + "</a>")
  ]]></function>
  <function name="ProcessTextCommand_Exit" parameters="section, data" type="string"><![CDATA[
    exitname = Mid(section, 6)
    exit = GetObject(exitname)
    if (exit = null) {
      return ("@@@open@@@" + ProcessTextSection(section, data) + "@@@close@@@")
    }
    else {
      verbs = GetDisplayVerbs(exit)
      alias = GetDisplayAlias(exit)
      command = LCase(StringListItem(verbs, 0)) + " " + alias
      style = GetCurrentLinkTextFormat()
      return ("<a style=\"" + style + "\" class=\"cmdlink exitlink\" data-elementid=\"" + exit.name + "\" data-command=\"" + command + "\">" + alias + "</a>")
    }
  ]]></function>
  <function name="ProcessTextCommand_Once" parameters="section, data" type="string">
    if (not HasAttribute(game, "textprocessor_seen")) {
      game.textprocessor_seen = NewDictionary()
    }
    fulltext = StringDictionaryItem(data, "fulltext")
    if (not DictionaryContains(game.textprocessor_seen, fulltext)) {
      onceSectionsInThisText = NewList()
      dictionary add (game.textprocessor_seen, fulltext, onceSectionsInThisText)
    }
    else {
      onceSectionsInThisText = DictionaryItem(game.textprocessor_seen, fulltext)
    }
    if (not ListContains(onceSectionsInThisText, section)) {
      list add (onceSectionsInThisText, section)
      return (ProcessTextSection(Mid(section, 6), data))
    }
    else {
      return ("")
    }
  </function>
  <function name="ProcessTextCommand_NotFirst" parameters="section, data" type="string">
    if (not HasAttribute(game, "textprocessor_seen")) {
      game.textprocessor_seen = NewDictionary()
    }
    fulltext = StringDictionaryItem(data, "fulltext")
    if (not DictionaryContains(game.textprocessor_seen, fulltext)) {
      onceSectionsInThisText = NewList()
      dictionary add (game.textprocessor_seen, fulltext, onceSectionsInThisText)
    }
    else {
      onceSectionsInThisText = DictionaryItem(game.textprocessor_seen, fulltext)
    }
    if (not ListContains(onceSectionsInThisText, section)) {
      list add (onceSectionsInThisText, section)
      return ("")
    }
    else {
      return (ProcessTextSection(Mid(section, 10), data))
    }
  </function>
  <function name="ProcessTextCommand_Random" parameters="section, data" type="string">
    elements = Mid(section, 8)
    elementslist = Tsplit(elements)
    index = GetRandomInt(0, ListCount(elementslist) - 1)
    return (ProcessTextSection(ListItem(elementslist, index), data))
  </function>
  <function name="Tsplit" parameters="splittext" type="stringlist"><![CDATA[
    itemlist = NewStringList()
    sections = 0
    startpos = 1
    for (i, 1, LengthOf(splittext)) {
      if (Mid(splittext, i, 1) = "{") {
          sections = sections + 1
        }
        if (Mid(splittext, i, 1) = "}") {
        sections = sections - 1
      }
      if (Mid(splittext, i, 1) = ":" and 0 >= sections) {
        item = Mid(splittext, startpos, i - startpos)
        list add (itemlist, item)
        startpos = i + 1
      }
    }
    item = Mid(splittext, startpos)
    list add (itemlist, item)
    return (itemlist)
  ]]></function>
  <function name="ProcessTextCommand_RandomAlias" parameters="section, data" type="string"><![CDATA[
    objectname = Mid(section, 8)
    object = ObjectForTextProcessor(objectname)
    if (object = null) {
      return ("@@@open@@@" + ProcessTextSection(section, data) + "@@@close@@@")
    }
    else {
      count = ListCount(object.alt)
      if (count > 0) {
        return (ListItem(object.alt, GetRandomInt(0, count - 1)))
      }
      else {
        return ("")
      }
    }
  ]]></function>
  <function name="ProcessTextCommand_Img" parameters="section, data" type="string"><![CDATA[
    filename = Mid(section, 5)
    return ("<img src=\"" + GetFileURL(filename) + "\" />")
  ]]></function>
  <function name="ProcessTextCommand_Counter" parameters="section, data" type="string">
    section = Mid(section, 9)
    if (HasAttribute(game, section)) {
      return (ToString(GetAttribute(game, section)))
    }
    else {
      return ("0")
    }
  </function>
  <function name="ProcessTextCommand_Select" parameters="section, data" type="string"><![CDATA[
    elements = Mid(section, 8)
    elementslist = Tsplit(elements)
    objectandatt = StringListItem (elementslist, 0)
    list remove (elementslist, objectandatt)
    objectandattlist = Split(objectandatt, ".")
    if (not ListCount (objectandattlist) = 2) {
      return ("@@@open@@@" + ProcessTextSection(section, data) + "@@@close@@@")
    }
    else {
      objectname = StringListItem(objectandattlist, 0)
      object = ObjectForTextProcessor(objectname)
      if (object = null) {
        return ("@@@open@@@" + ProcessTextSection(section, data) + "@@@close@@@")
      }
      else if (not HasInt (object, StringListItem(objectandattlist, 1))) {
        return ("@@@open@@@" + ProcessTextSection(section, data) + "@@@close@@@")
      }
      else {
        if (Instr(elements, "|") > 0) {
          elementslist = Split(Join(elementslist, ":"), "|")
        }
        index = GetInt(object, StringListItem(objectandattlist, 1))
        if ((0 > index) or (index >= Listcount(elementslist))) {
          return ("@@@open@@@" + ProcessTextSection(section, data) + "@@@close@@@")
        }
        else {
          return (ProcessTextSection(ListItem(elementslist, index), data))
        }
      }
    }
  ]]></function>
  <function name="SetFramePicture" parameters="filename"><![CDATA[
    JS.setPanelContents ("<img src=\"" + GetFileURL(filename) + "\" onload=\"setPanelHeight()\"/>")
    game.panelcontents = filename
  ]]></function>
  <function name="ClearFramePicture">
    JS.setPanelContents ("")
    game.panelcontents = null
  </function>
  <function name="ClearScreen">
    JS.clearScreen ()
  </function>
  <function name="SetForegroundColour" parameters="colour">
    // request (Foreground, colour)
    game.defaultforeground = colour
  </function>
  <function name="SetBackgroundColour" parameters="colour">
    JS.setBackground (colour)
    game.defaultbackground = colour
  </function>
  <function name="SetLinkForegroundColour" parameters="colour">
    // request (LinkForeground, colour)
    game.defaultlinkforeground = colour
  </function>
  <function name="SetFontName" parameters="font">
    game.defaultfont = font
    game.defaultwebfont = ""
  </function>
  <function name="SetWebFontName" parameters="font">
    AddExternalStylesheet ("https://fonts.googleapis.com/css?family=" + Replace(font, " ", "+"))
    game.defaultwebfont = font
  </function>
  <function name="AddExternalStylesheet" parameters="stylesheet">
    if (game.externalstylesheets = null) {
      game.externalstylesheets = NewStringList()
    }
    if (not ListContains(game.externalstylesheets, stylesheet)) {
      list add (game.externalstylesheets, stylesheet)
      JS.addExternalStylesheet (stylesheet)
    }
  </function>
  <function name="SetFontSize" parameters="size">
    game.defaultfontsize = size
  </function>
  <function name="PrintCentered" parameters="text">
    SetAlignment ("center")
    msg (text)
    SetAlignment ("left")
  </function>
  <function name="ShowYouTube" parameters="id">
    JS.AddYouTube (id)
  </function>
  <function name="ShowVimeo" parameters="id">
    JS.AddVimeo (id)
  </function>
  <function name="DisplayHttpLink" parameters="text, url, https"><![CDATA[
    pos = Instr(url, "://")
    if (pos > 0) {
      url = Mid(url, pos + 3)
    }
    if (https) {
      url = "https://" + url
    }
    else {
      url = "http://" + url
    }
    msg ("<a style=\"" + GetCurrentLinkTextFormat() + "\" href=\"" + url + "\">" + text + "</a>")
  ]]></function>
  <function name="DisplayMailtoLink" parameters="text, url"><![CDATA[
    if (Instr(url, "mailto:") = 0) {
      url = "mailto:" + url
    }
    msg ("<a style=\"" + GetCurrentLinkTextFormat() + "\" href=\"" + url + "\">" + text + "</a>")
  ]]></function>
  <function name="CommandLink" parameters="cmd, text" type="string">
    return ("{command:" + cmd + ":" + text + "}")
  </function>
  <function name="Log" parameters="text"><![CDATA[
    // request (Log, text)
    // Replacing double quotes with 2 single quotes
    text = Replace(text, "\"", "''")
    // Changing syntax from single quotes to escaped double quotes to allow single quotes in log entries
    if (not GetBoolean(game, "nohtmllog")) {
      JS.eval ("if(typeof(addLogEntry)===\"function\"){ addLogEntry(\""+text+"\"); };")
    }
    JS.eval ("if(!webPlayer && typeof(WriteToLog)===\"function\"){var s = \""+text+"\";WriteToLog(s);}")
  ]]></function>
  <function name="SetBackgroundImage" parameters="filename">
    JS.SetBackgroundImage (GetFileURL(filename))
    game.backgroundimage = filename
  </function>
  <function name="SetBackgroundOpacity" parameters="opacity">
    JS.SetBackgroundOpacity (opacity)
    game.backgroundopacity = opacity
    game.setbackgroundopacity = true
  </function>
  <function name="DisplayList" parameters="list, numbers"><![CDATA[
    if (numbers) {
      result = "<ol>"
    }
    else {
      result = "<ul>"
    }
    foreach (item, list) {
      result = result + "<li>" + item + "</li>"
    }
    if (numbers) {
      result = result + "</ol>"
    }
    else {
      result = result + "</ul>"
    }
    msg (result)
  ]]></function>
  <function name="SetAlignment" parameters="align">
    JS.createNewDiv (align)
  </function>
  <function name="GetCurrentFontFamily" type="string">
    if (game.defaultwebfont = null) {
      return (game.defaultfont)
    }
    else {
      if (game.defaultwebfont = "") {
        return (game.defaultfont)
      }
      else {
        return ("'" + game.defaultwebfont + "', " + game.defaultfont)
      }
    }
  </function>
  <function name="FormatList" parameters="list, joiner, lastjoiner, nothing" type="string"><![CDATA[
    if (ListCount (list) = 0) {
      return (nothing)
    }
    else {
      result = ""
      count = 0
      listLength = ListCount(list)
      foreach (item, list) {
        if (TypeOf(item) = "object") {
          result = result + GetDisplayName(item)
        }
        else {
          result = result + item
        }
        count = count + 1
        if (count = listLength - 1) {
          if (not IsRegexMatch("^\\W", lastjoiner)) {
            result = result + " "
          }
          result = result + lastjoiner + " "
        }
        else if (count < listLength) {
          result = result + joiner + " "
        }
      }
      return (Trim (result))
    }
  ]]></function>
  <function name="Spaces" parameters="number" type="string"><![CDATA[
    game.command_successful = True
    text = ""
    for (x, 1, number) {
      text = text+ "&nbsp;"
    }
    return (text)
  ]]></function>
  <function name="ToRoman" parameters="n" type="string"><![CDATA[
    if (not TypeOf(n) = "int") {
      error ("ToRoman can only handle ints")
    }
    arabic = Split("1000;900;500;400;100;90;50;40;10;9;5;4;1", ";")
    roman = Split("M;CM;D;CD;C;XC;L;XL;X;IX;V;IV;I", ";")
    result = ""
    for (i, 0, 12) {
      a = ToInt(StringListItem(arabic, i))
      r = StringListItem(roman, i)
      while (n >= a) {
        result = result + r
        n = n - a
      }
    }
    return (result)
  ]]></function>
  <function name="TextFX_Typewriter" parameters="text, speed">
    TextFX_Typewriter_Internal (text, speed, GetCurrentFontFamily(), game.defaultforeground, game.defaultfontsize)
  </function>
  <function name="TextFX_Typewriter_Internal" parameters="text, speed, font, color, size">
    JS.TextFX.Typewriter (text, speed, font, color, size)
  </function>
  <function name="TextFX_Unscramble" parameters="text, speed, reveal">
    TextFX_Unscramble_Internal (text, speed, reveal, GetCurrentFontFamily(), game.defaultforeground, game.defaultfontsize)
  </function>
  <function name="TextFX_Unscramble_Internal" parameters="text, speed, reveal, font, color, size">
    JS.TextFX.Unscramble (text, speed, reveal, font, color, size)
  </function>
  <function name="InitInterface">
    if (game.setcustomwidth) {
      JS.setGameWidth (game.customwidth)
    }
    if (not game.showborder) {
      JS.hideBorder ()
    }
    if (game.setcustompadding) {
      JS.setGamePadding (game.custompaddingtop, game.custompaddingbottom, game.custompaddingleft, game.custompaddingright)
    }
    SetBackgroundColour (game.defaultbackground)
    SetForegroundColour (game.defaultforeground)
    SetLinkForegroundColour (game.defaultlinkforeground)
    JS.SetMenuBackground (game.menubackground)
    JS.SetMenuForeground (game.menuforeground)
    JS.SetMenuHoverBackground (game.menuhoverbackground)
    JS.SetMenuHoverForeground (game.menuhoverforeground)
    JS.SetMenuFontName (game.menufont)
    JS.SetMenuFontSize (game.menufontsize + "pt")
    JS.panesVisible (false)
    JS.uiHide ("#location")
    JS.uiHide ("#txtCommandDiv")
  </function>
  <function name="StartGame"><![CDATA[
    if (game.showtitle) {
      PrintCentered ("<span style=\"font-size:260%\">" + game.gamename + "</span>")
      if (game.subtitle <> null) {
        if (LengthOf(game.subtitle) > 0) {
          PrintCentered ("<span style=\"font-size:130%\">" + game.subtitle + "</span>")
        }
      }
      if (game.author <> null) {
        if (LengthOf(game.author) > 0) {
          PrintCentered ("<br/><span style=\"font-size:140%\">" + game.author + "</span>")
        }
      }
      msg ("<div style=\"margin-top:20px\"></div>")
    }
    game.noclear = true
    DoPage (player.parent)
    game.noclear = false
  ]]></function>
  <function name="ScopeInventory" type="objectlist">
    result = NewObjectList()
    return (result)
  </function>
  <function name="GetPlacesObjectsList" type="objectlist">
    result = NewObjectList()
    return (result)
  </function>
  <function name="ScopeExits" type="objectlist">
    result = NewObjectList()
    return (result)
  </function>
  <function name="ScopeCommands" type="objectlist">
    result = NewObjectList()
    foreach (command, AllCommands()) {
      if (command.parent = game.pov.parent) {
        list add (result, command)
      }
    }
    return (result)
  </function>
  <function name="HandleCommand" parameters="command"><![CDATA[
    if (command = "undo") {
      // ignore
    }
    else {
      newpage = GetObject(command)
      if (newpage = null) {
        msg ("Error - no page named '" + command + "'")
      }
      else {
        if (not game.clearlastpage and HasAttribute(player.parent, "options")) {
          if (DictionaryContains(player.parent.options, command)) {
            optiontext = StringDictionaryItem(player.parent.options, command)
            msg ("<b>" + optiontext + "</b>")
            msg ("")
          }
          JS.disableAllCommandLinks ()
        }
        player.parent = GetObject(command)
      }
    }
  ]]></function>
  <function name="DoPage" parameters="page"><![CDATA[
    parent = player.parent
    if (game.clearlastpage) {
      if (not game.noclear) {
        ClearScreen
      }
    }
    else {
      if (HasString(game, "optionsoutputsection")) {
        HideOutputSection (game.optionsoutputsection)
      }
    }
    if (not GetBoolean(game, "continuesound")) {
      stop sound
    }
    if (HasScript( game, "roomenter")) {
      do (game, "roomenter")
    }
    on ready {
      if (GetBoolean(player.parent, "runscript") or GetBoolean(player.parent, "runscriptonly")) {
        if (HasScript(player.parent, "script")) {
          do (player.parent, "script")
        }
        else {
          msg ("No script has been created for this page.")
        }
      }
      // script may have moved the player, so finish DoPage if parent has changed
      if (parent = player.parent and not GetBoolean(player.parent, "runscriptonly")) {
        if (HasString(player.parent, "sound")) {
          if (LengthOf(player.parent.sound) > 0) {
            play sound (player.parent.sound, false, false)
            game.continuesound = GetBoolean(player.parent, "continuesound")
          }
        }
        if (HasString(player.parent, "picture")) {
          if (LengthOf(player.parent.picture) > 0) {
            picture (player.parent.picture)
            msg ("")
          }
        }
        if (HasString(player.parent, "youtube")) {
          if (LengthOf(player.parent.youtube) > 0) {
            JS.AddYouTube (player.parent.youtube)
            msg ("")
            msg ("")
          }
        }
        msg (player.parent.description)
        msg ("")
        msg ("")
        game.optionsoutputsection = StartNewOutputSection()
        if (TypeOf(player.parent, "options") = "stringdictionary") {
          foreach (key, player.parent.options) {
            destination = GetObject(key)
            if (destination = null) {
              msg (StringDictionaryItem(player.parent.options, key) + " (broken link)")
            }
            else {
              if (DoesInherit(destination, "link")) {
                msg ("<a href=\"" + destination.address + "\">" + StringDictionaryItem(player.parent.options, key) + "</a>")
              }
              else {
                msg (CommandLink(key, StringDictionaryItem(player.parent.options, key)))
              }
            }
            msg ("")
          }
        }
        EndOutputSection (game.optionsoutputsection)
      }
    }
    set (player.parent, "visited", true)
  ]]></function>
  <function name="StartNewOutputSection" type="string">
    if (not HasInt(game, "lastoutputsection")) {
      game.lastoutputsection = 0
    }
    game.lastoutputsection = game.lastoutputsection + 1
    name = "section" + game.lastoutputsection
    JS.StartOutputSection (name)
    return (name)
  </function>
  <function name="EndOutputSection" parameters="name">
    JS.EndOutputSection (name)
  </function>
  <function name="HideOutputSection" parameters="name">
    JS.HideOutputSection (name)
  </function>
  <function name="RandomChance" parameters="percentile" type="boolean"><![CDATA[
    return (GetRandomInt(1,100) <= percentile)
  ]]></function>
  <function name="HasSeenPage" parameters="page" type="boolean">
    return (GetBoolean(page, "visited"))
  </function>
  <function name="SetFlagOn" parameters="flag">
    set (game, flag, true)
  </function>
  <function name="SetFlagOff" parameters="flag">
    set (game, flag, false)
  </function>
  <function name="SetCounter" parameters="counter, value">
    set (game, counter, value)
  </function>
  <function name="ChangeCounter" parameters="counter, value">
    if (not HasInt(game, counter)) {
      set (game, counter, 0)
    }
    set (game, counter, GetInt(game, counter) + value)
  </function>
  <function name="IncreaseCounter" parameters="counter">
    if (not HasInt(game, counter)) {
      set (game, counter, 0)
    }
    set (game, counter, GetInt(game, counter) + 1)
  </function>
  <function name="DecreaseCounter" parameters="counter">
    if (not HasInt(game, counter)) {
      set (game, counter, 0)
    }
    set (game, counter, GetInt(game, counter) - 1)
  </function>
  <function name="GetInput" parameters="callback">
    JS.uiShow ("#txtCommandDiv")
    get input {
      JS.uiHide ("#txtCommandDiv")
      parameters = NewStringDictionary()
      dictionary add (parameters, "result", result)
      invoke (callback, parameters)
    }
  </function>
  <function name="AddPageLink" parameters="source, destination, text">
    RemovePageLink (source, destination)
    dictionary add (source.options, destination.name, text)
  </function>
  <function name="RemovePageLink" parameters="source, destination">
    if (source.options = null) {
      source.options = NewStringDictionary()
    }
    if (DictionaryContains(source.options, destination.name)) {
      dictionary remove (source.options, destination.name)
    }
  </function>
  <function name="MovePlayer" parameters="destination">
    player.parent = destination
  </function>
  <function name="ShowMenu" parameters="caption, options, allowCancel, callback"><![CDATA[
    outputsection = StartNewOutputSection()
    msg (caption)
    count = 0
    game.menuoptionskeys = NewStringList()
    foreach (option, options) {
      count = count + 1
      if (TypeOf(options) = "stringdictionary") {
        optionText = StringDictionaryItem(options, option)
        optiontag = option
        style = GetCurrentLinkTextFormat()
        list add (game.menuoptionskeys, option)
      }
      else if (TypeOf(option) = "string") {
        optionText = option
        optiontag = option
        style = GetCurrentLinkTextFormat()
        list add (game.menuoptionskeys, option)
      }
      else if (TypeOf(option) = "object") {
        optionText = GetDisplayAlias(option)
        optiontag = option.name
        colour = ""
        if (HasString(option, "linkcolour") and GetUIOption("UseGameColours") = "true") {
          colour = option.linkcolour
        }
        else {
          colour = GetLinkTextColour()
        }
        style = GetCurrentTextFormat(colour)
        list add (game.menuoptionskeys, option.name)
      }
      else {
        error ("ShowMenu cannot handle a " + TypeOf(option))
      }
      msg (count + ": <a class=\"cmdlink\" style=\"" + style + "\" onclick=\"ASLEvent('ShowMenuResponse','" + EscapeQuotes(optiontag) + "')\">" + optionText + "</a>")
    }
    EndOutputSection (outputsection)
    game.menuoptions = options
    game.menuallowcancel = allowCancel
    game.menucallback = callback
    game.menuoutputsection = outputsection
  ]]></function>
  <function name="ShowMenuResponse" parameters="option">
    if (game.menucallback = null) {
      error ("Unexpected menu response")
    }
    else {
      parameters = NewStringDictionary()
      dictionary add (parameters, "result", UnescapeQuotes(option))
      script = game.menucallback
      ClearMenu
      invoke (script, parameters)
    }
  </function>
  <function name="EscapeQuotes" parameters="s" type="string">
    s = Replace(s, "\"", "@@@doublequote@@@")
    s = Replace(s, "\'", "@@@singlequote@@@")
    return (s)
  </function>
  <function name="UnescapeQuotes" parameters="s" type="string">
    s = Replace(s, "@@@doublequote@@@", "\"")
    s = Replace(s, "@@@singlequote@@@", "\'")
    return (s)
  </function>
  <function name="ClearMenu">
    HideOutputSection (game.menuoutputsection)
    game.menuoutputsection = null
    game.menuoptions = null
    game.menucallback = null
  </function>
  <function name="RequestSpeak" parameters="s">
    request (Speak, s)
  </function>
</asl>